5A8	Aleknagik / New Airport	US
AF-0005	Khost International Airport	AF
AGGH	Honiara International Airport	SB
AGGM	Munda Airport	SB
AHJ	Hongyuan Airport	CN
ANYN	Nauru International Airport	NR
AQBC	Boulder Clay Runway	AQ
AT03	Concordia Skyway	AQ
AT28	Vostok Skiway	AQ
AXF	Alxa Left Banner Bayanhot Airport	CN
AYBK	Buka Airport	PG
AYCH	Chimbu Airport	PG
AYDU	Daru Airport	PG
AYGA	Goroka Airport	PG
AYGN	Gurney Airport	PG
AYGR	Girua Airport	PG
AYHK	Hoskins Airport	PG
AYKM	Kerema Airport	PG
AYKV	Kavieng Airport	PG
AYMD	Madang Airport	PG
AYMH	Mount Hagen Kagamuga Airport	PG
AYMN	Mendi Airport	PG
AYMO	Momote Airport	PG
AYNZ	Nadzab Airport	PG
AYPY	Port Moresby Jacksons International Airport	PG
AYTK	Tokua Airport	PG
AYVN	Vanimo Airport	PG
AYWD	Wapenamanda Airport	PG
AYWK	Wewak International Airport	PG
AZ-0001	Zabrat Airport	AZ
AZ-0013	Sitalchay Airbase	AZ
AZ-0021	Qizilagach Air Base	AZ
BCW	Benguera Island Airport	MZ
BG-JAM	Bezmer Air Base	BG
BGAA	Aasiaat Airport	GL
BGBW	Narsarsuaq Airport	GL
BGGH	Nuuk Airport	GL
BGKK	Kulusuk Airport	GL
BGSF	Kangerlussuaq Airport	GL
BGSS	Sisimiut Airport	GL
BGTL	Thule Air Base	GL
BIAR	Akureyri Airport	IS
BIEG	Egilsstaðir Airport	IS
BIHN	Hornafjörður Airport	IS
BIHU	Húsavík Airport	IS
BIIS	Ísafjörður Airport	IS
BIKF	Keflavik International Airport	IS
BIRK	Reykjavik Airport	IS
BISI	Siglufjörður Airport	IS
BIVM	Vestmannaeyjar Airport	IS
BKPR	Priština Adem Jashari International Airport	XK
BR-0569	Glauber de Andrade Rocha Airport	BR
BTZ	Betong International Airport	TH
BY-0001	Orsha Airport - Balbasovo Air Base	BY
BY-0003	Bobrovichi Air Base	BY
BY-0006	Osovtsy Air Base	BY
BZ-BGK	Big Creek Airport	BZ
BZ-CUK	Caye Caulker Airport	BZ
BZ-CYC	Caye Chapel Airport	BZ
BZ-CZH	Corozal Municipal Airport	BZ
BZ-DGA	Dangriga Airport	BZ
BZ-PLJ	Placencia Airport	BZ
BZ-PND	Punta Gorda Airport	BZ
BZ-SJX	Sartaneja Airport	BZ
BZ-SPR	John Greif II Airport	BZ
BZ-TZA	Sir Barry Bowen Municipal Airport	BZ
BZB	Bazaruto Island Airport	MZ
CA-0582	Bamfield Airstrip	CA
CAJ4	Anahim Lake Airport	CA
CAZ5	Cache Creek-Ashcroft Regional Airport	CA
CBBC	Bella Bella (Campbell Island) Airport	CA
CD-0024	Boma Lukandu International Airport	CD
CL-0015	Nuevo Chaitén Airport	CL
CN-0003	Laohutun Air Base	CN
CN-0004	Pulandian Air Base	CN
CN-0006	Beijing Shahezhen Air Base	CN
CN-0007	Beijing Tongxian Air Base	CN
CN-0012	Yuanmou Air Base	CN
CN-0013	Fengning Air Base	CN
CN-0014	Hohhot Bikeqi Air Base	CN
CN-0015	Huairen Air Base	CN
CN-0016	Liangxiangzhen Air Base	CN
CN-0018	Tangguantun Air Base	CN
CN-0020	Wenshui Air Base	CN
CN-0021	Yangcun Air Base	CN
CN-0022	Yongning Air Base	CN
CN-0024	Zhangjiakou Ningyuan Airport	CN
CN-0025	Tangshan Zunhua Air Base	CN
CN-0026	Chengdu Huangtianba Air Base	CN
CN-0027	Baoshan Yunrui Airport	CN
CN-0030	Chongqing Baishiyi Air Base	CN
CN-0040	Lincang Boshang Airport	CN
CN-0041	Luliang Air Base	CN
CN-0043	Honghe Mengzi Airport / Mengzi Air Base	CN
CN-0045	Qionglai Air Base	CN
CN-0046	Xigaze Peace Airport / Shigatse Air Base	CN
CN-0048	Wenshan Air Base	CN
CN-0049	Xiangyun Midu Air Base	CN
CN-0050	Panzhihua Bao'anying Airport	CN
CN-0053	Baihe Ningming Air Base	CN
CN-0055	Changsha Datuopu Airport / Changsha Air Base	CN
CN-0056	Dangyang Air Base	CN
CN-0057	Foluo Northeast Air Base	CN
CN-0061	Foshan Shadi Airport	CN
CN-0063	Guiping Mengxu Air Base	CN
CN-0067	Xinyang Minggang Airport	CN
CN-0068	Huizhou Pingtan Airport	CN
CN-0069	Jialaishi Air Base	CN
CN-0071	Leiyang Air Base	CN
CN-0072	Lingshui Air Base	CN
CN-0074	Shangqiu Air Base	CN
CN-0076	Zhengzhou Air Base	CN
CN-0079	Shaoguan Danxia Airport	CN
CN-0080	Suixi Air Base	CN
CN-0081	Jinggangshan Airport	CN
CN-0082	Baise Youjiang Airport	CN
CN-0083	Guodu Air Base	CN
CN-0085	Xiaogan Air Base	CN
CN-0089	Lianyungang Huaguoshan International Airport	CN
CN-0090	Cangxian Air Base	CN
CN-0091	Dongying Shengli Airport	CN
CN-0092	Jiaozhou Jiaocheng Air Base	CN
CN-0094	Jiugucheng Air Base	CN
CN-0095	Kaifeng Air Base	CN
CN-0096	Laiyang Air Base	CN
CN-0097	Luyang Air Base	CN
CN-0104	Xingcheng Air Base	CN
CN-0106	Xuzhou Daguozhang Air Base	CN
CN-0111	Zhucheng Air Base	CN
CN-0113	Altay Xuedu Airport	CN
CN-0114	Baoji Air Base	CN
CN-0117	Gonghe Air Base	CN
CN-0121	Huangdicun Naval Air Base	CN
CN-0123	Lanzhou Air Base	CN
CN-0125	Lintao Air Base	CN
CN-0127	Qingshui Air Base	CN
CN-0130	Tianshui Maijishan Airport	CN
CN-0132	Ürümqi South Air Base	CN
CN-0133	Uxxaktal Air Base	CN
CN-0134	Wugong Air Base	CN
CN-0135	Ürümqi Changji Air Base	CN
CN-0136	Wuwei Air Base	CN
CN-0137	Xi'an Air Base	CN
CN-0138	Xincheng Air Base	CN
CN-0139	Yaerbashi Test Range	CN
CN-0140	Yanliang Air Base	CN
CN-0146	Daishan Air Base	CN
CN-0147	Feidong Air Base	CN
CN-0149	Fuzhou Air Base	CN
CN-0152	Huian Air Base	CN
CN-0153	Hangzhou Jianqiao Airport	CN
CN-0154	Jiaxing Airport / Jiaxing Air Base	CN
CN-0158	Longtian Air Base	CN
CN-0163	Nanchang Xiangtang Air Base	CN
CN-0165	Ningbo Zhuangqiao Air Base	CN
CN-0169	Shanghai Dachang Air Base	CN
CN-0182	Zhangshu Air Base	CN
CN-0185	Changchun Air Base	CN
CN-0188	Beijing Nanjiao Airport	CN
CN-0189	Dandong Langtou Airport	CN
CN-0190	Dingxin-Shuangchengzi Air Base	CN
CN-0191	Fuxin Air Base	CN
CN-0192	Gongzhuling Air Base	CN
CN-0197	Kaiyuan Air Base	CN
CN-0198	Lalin Air Base	CN
CN-0201	Pingquan Air Base	CN
CN-0204	Shenyang Beiling Air Base	CN
CN-0206	Shenyang Yuhong Quansheng Airport	CN
CN-0208	Siping Air Base	CN
CN-0209	Suizhong Air Base	CN
CN-0210	Tuchengzi Air Base	CN
CN-0236	Xigaze Dingri Airport	CN
CN-0316	Chenghu General Airport	CN
CN-0317	Liyang Tianmuhu General Airport	CN
CN-0321	Anji Tianzihu General Airport	CN
CN-0331	Jiuzhou Airport	CN
CN-0344	Paozhuwan Air Base	CN
CN-0345	Shanpo Air Base	CN
CN-0353	Zhanjiang Wuchuan Airport	CN
CN-0396	Shaodong Airport	CN
CN-0401	Ningxiang	CN
CN-JNZ	Sanshilipu Air Base	CN
CN-NTG	Nantong Xingdong International Airport	CN
CNC3	Brampton-Caledon Airport	CA
CY-0002	Lefkoniko Airport / Geçitkale Air Base	CY
CYAC	Cat Lake Airport	CA
CYAG	Fort Frances Municipal Airport	CA
CYAH	La Grande-4 Airport	CA
CYAL	Alert Bay Airport	CA
CYAM	Sault Ste Marie Airport	CA
CYAQ	Kasabonika Airport	CA
CYAS	Kangirsuk Airport	CA
CYAT	Attawapiskat Airport	CA
CYAV	Winnipeg / St. Andrews Airport	CA
CYAX	Lac Du Bonnet Airport	CA
CYAY	St. Anthony Airport	CA
CYAZ	Tofino / Long Beach Airport	CA
CYBB	Kugaaruk Airport	CA
CYBC	Baie-Comeau Airport	CA
CYBD	Bella Coola Airport	CA
CYBE	Uranium City Airport	CA
CYBF	Bonnyville Airport	CA
CYBG	CFB Bagotville	CA
CYBK	Baker Lake Airport	CA
CYBL	Campbell River Airport	CA
CYBQ	Tadoule Lake Airport	CA
CYBR	Brandon Municipal Airport	CA
CYBT	Brochet Airport	CA
CYBU	Nipawin Airport	CA
CYBV	Berens River Airport	CA
CYBW	Calgary / Springbank Airport	CA
CYBX	Lourdes-de-Blanc-Sablon Airport	CA
CYCA	Cartwright Airport	CA
CYCB	Cambridge Bay Airport	CA
CYCC	Cornwall Regional Airport	CA
CYCD	Nanaimo Airport	CA
CYCE	Centralia / James T. Field Memorial Aerodrome	CA
CYCG	Castlegar/West Kootenay Regional Airport	CA
CYCH	Miramichi Airport	CA
CYCL	Charlo Airport	CA
CYCN	Cochrane Airport	CA
CYCO	Kugluktuk Airport	CA
CYCP	Blue River Airport	CA
CYCQ	Chetwynd Airport	CA
CYCR	Cross Lake (Charlie Sinclair Memorial) Airport	CA
CYCS	Chesterfield Inlet Airport	CA
CYCY	Clyde River Airport	CA
CYDA	Dawson City Airport	CA
CYDB	Burwash Airport	CA
CYDC	Princeton Airport	CA
CYDF	Deer Lake Airport	CA
CYDM	Ross River Airport	CA
CYDN	Dauphin Barker Airport	CA
CYDO	Dolbeau St Felicien Airport	CA
CYDP	Nain Airport	CA
CYDQ	Dawson Creek Airport	CA
CYEE	Huronia Airport	CA
CYEG	Edmonton International Airport	CA
CYEK	Arviat Airport	CA
CYEL	Elliot Lake Municipal Airport	CA
CYEM	Manitoulin East Municipal Airport	CA
CYEN	Estevan Airport	CA
CYER	Fort Severn Airport	CA
CYET	Edson Airport	CA
CYEV	Inuvik Mike Zubko Airport	CA
CYEY	Amos/Magny Airport	CA
CYFA	Fort Albany Airport	CA
CYFB	Iqaluit Airport	CA
CYFC	Fredericton Airport	CA
CYFE	Forestville Airport	CA
CYFH	Fort Hope Airport	CA
CYFJ	Mont-Tremblant International Airport	CA
CYFO	Flin Flon Airport	CA
CYFR	Fort Resolution Airport	CA
CYFS	Fort Simpson Airport	CA
CYFT	Makkovik Airport	CA
CYGB	Texada Gillies Bay Airport	CA
CYGD	Goderich Airport	CA
CYGE	Golden Airport	CA
CYGH	Fort Good Hope Airport	CA
CYGK	Kingston Norman Rogers Airport	CA
CYGL	La Grande Rivière Airport	CA
CYGM	Gimli Industrial Park Airport	CA
CYGO	Gods Lake Narrows Airport	CA
CYGP	Gaspé (Michel-Pouliot) Airport	CA
CYGQ	Geraldton Greenstone Regional Airport	CA
CYGR	Îles-de-la-Madeleine Airport	CA
CYGT	Igloolik Airport	CA
CYGV	Havre-Saint-Pierre Airport	CA
CYGW	Kuujjuarapik Airport	CA
CYGX	Gillam Airport	CA
CYGZ	Grise Fiord Airport	CA
CYHA	Quaqtaq Airport	CA
CYHD	Dryden Regional Airport	CA
CYHE	Hope Airport / FVRD Regional Airpark	CA
CYHF	Hearst René Fontaine Municipal Airport	CA
CYHH	Nemiscau Airport	CA
CYHI	Ulukhaktok Holman Airport	CA
CYHK	Gjoa Haven Airport	CA
CYHM	John C. Munro Hamilton International Airport	CA
CYHN	Hornepayne Municipal Airport	CA
CYHO	Hopedale Airport	CA
CYHR	Chevery Airport	CA
CYHT	Haines Junction Airport	CA
CYHU	Montréal / Saint-Hubert Airport	CA
CYHY	Hay River / Merlyn Carter Airport	CA
CYHZ	Halifax / Stanfield International Airport	CA
CYIB	Atikokan Municipal Airport	CA
CYID	Digby / Annapolis Regional Airport	CA
CYIF	St Augustin Airport	CA
CYIK	Ivujivik Airport	CA
CYIO	Pond Inlet Airport	CA
CYIV	Island Lake Airport	CA
CYJF	Fort Liard Airport	CA
CYJN	St Jean Airport	CA
CYJT	Stephenville Airport	CA
CYKA	Kamloops Airport	CA
CYKD	Aklavik/Freddie Carmichael Airport	CA
CYKF	Waterloo Airport	CA
CYKG	Kangiqsujuaq (Wakeham Bay) Airport	CA
CYKJ	Key Lake Airport	CA
CYKL	Schefferville Airport	CA
CYKO	Akulivik Airport	CA
CYKQ	Waskaganish Airport	CA
CYKX	Kirkland Lake Airport	CA
CYKY	Kindersley Airport	CA
CYKZ	Buttonville Municipal Airport	CA
CYLA	Aupaluk Airport	CA
CYLC	Kimmirut Airport	CA
CYLD	Chapleau Airport	CA
CYLH	Lansdowne House Airport	CA
CYLJ	Meadow Lake Airport	CA
CYLK	Lutselk'e Airport	CA
CYLL	Lloydminster Airport	CA
CYLR	Leaf Rapids Airport	CA
CYLT	Alert Airport	CA
CYLU	Kangiqsualujjuaq (Georges River) Airport	CA
CYLW	Kelowna International Airport	CA
CYMA	Mayo Airport	CA
CYME	Matane Airport	CA
CYMG	Manitouwadge Airport	CA
CYMH	Mary's Harbour Airport	CA
CYMJ	Moose Jaw Air Vice Marshal C. M. McEwen Airport	CA
CYML	Charlevoix Airport	CA
CYMM	Fort McMurray Airport	CA
CYMO	Moosonee Airport	CA
CYMT	Chapais Airport	CA
CYMU	Umiujaq Airport	CA
CYMX	Montreal International (Mirabel) Airport	CA
CYNA	Natashquan Airport	CA
CYNC	Wemindji Airport	CA
CYND	Ottawa / Gatineau Airport	CA
CYNE	Norway House Airport	CA
CYNL	Points North Landing Airport	CA
CYNM	Matagami Airport	CA
CYNN	Nejanilini Lake Airport	CA
CYOA	Ekati Airport	CA
CYOC	Old Crow Airport	CA
CYOD	CFB Cold Lake	CA
CYOH	Oxford House Airport	CA
CYOJ	High Level Airport	CA
CYOO	Oshawa Executive Airport	CA
CYOP	Rainbow Lake Airport	CA
CYOS	Owen Sound / Billy Bishop Regional Airport	CA
CYOW	Ottawa Macdonald-Cartier International Airport	CA
CYPA	Prince Albert Glass Field	CA
CYPC	Paulatuk (Nora Aliqatchialuk Ruben) Airport	CA
CYPD	Port Hawkesbury Airport	CA
CYPE	Peace River Airport	CA
CYPG	Portage-la-Prairie / Southport Airport	CA
CYPH	Inukjuak Airport	CA
CYPL	Pickle Lake Airport	CA
CYPM	Pikangikum Airport	CA
CYPN	Port Menier Airport	CA
CYPO	Peawanuck Airport	CA
CYPQ	Peterborough Municipal Airport	CA
CYPR	Prince Rupert Airport	CA
CYPW	Powell River Airport	CA
CYPX	Puvirnituq Airport	CA
CYPY	Fort Chipewyan Airport	CA
CYPZ	Burns Lake Airport	CA
CYQA	Muskoka Airport	CA
CYQB	Quebec Jean Lesage International Airport	CA
CYQD	The Pas Airport	CA
CYQF	Red Deer Regional Airport	CA
CYQG	Windsor Airport	CA
CYQH	Watson Lake Airport	CA
CYQI	Yarmouth Airport	CA
CYQK	Kenora Airport	CA
CYQL	Lethbridge County Airport	CA
CYQM	Greater Moncton Roméo LeBlanc International Airport	CA
CYQN	Nakina Airport	CA
CYQQ	Comox Valley Airport / CFB Comox	CA
CYQR	Regina International Airport	CA
CYQS	St Thomas Municipal Airport	CA
CYQT	Thunder Bay Airport	CA
CYQU	Grande Prairie Airport	CA
CYQV	Yorkton Municipal Airport	CA
CYQW	North Battleford Airport	CA
CYQX	Gander International Airport / CFB Gander	CA
CYQY	Sydney / J.A. Douglas McCurdy Airport	CA
CYQZ	Quesnel Airport	CA
CYRA	Rae Lakes Airport	CA
CYRB	Resolute Bay Airport	CA
CYRI	Rivière-du-Loup Airport	CA
CYRJ	Roberval Airport	CA
CYRL	Red Lake Airport	CA
CYRO	Ottawa / Rockcliffe Airport	CA
CYRP	Ottawa / Carp Airport	CA
CYRQ	Trois-Rivières Airport	CA
CYRS	Red Sucker Lake Airport	CA
CYRT	Rankin Inlet Airport	CA
CYRV	Revelstoke Airport	CA
CYSB	Sudbury Airport	CA
CYSC	Sherbrooke Airport	CA
CYSF	Stony Rapids Airport	CA
CYSG	Saint-Georges Airport	CA
CYSH	Smiths Falls-Montague (Russ Beach) Airport	CA
CYSJ	Saint John Airport	CA
CYSK	Sanikiluaq Airport	CA
CYSL	Saint-Léonard Airport	CA
CYSM	Fort Smith Airport	CA
CYSN	Niagara District Airport	CA
CYSP	Marathon Airport	CA
CYSQ	Atlin Airport	CA
CYST	St. Theresa Point Airport	CA
CYSU	Summerside Airport	CA
CYSY	Sachs Harbour (David Nasogaluak Jr. Saaryuaq) Airport	CA
CYTA	Pembroke Airport	CA
CYTE	Cape Dorset Airport	CA
CYTF	Alma Airport	CA
CYTH	Thompson Airport	CA
CYTL	Big Trout Lake Airport	CA
CYTQ	Tasiujaq Airport	CA
CYTR	CFB Trenton	CA
CYTS	Timmins/Victor M. Power	CA
CYTZ	Billy Bishop Toronto City Centre Airport	CA
CYUB	Tuktoyaktuk / James Gruben Airport	CA
CYUL	Montreal / Pierre Elliott Trudeau International Airport	CA
CYUT	Naujaat Airport	CA
CYUX	Hall Beach Airport	CA
CYUY	Rouyn Noranda Airport	CA
CYVB	Bonaventure Airport	CA
CYVC	La Ronge Airport	CA
CYVD	Virden / RJ (Bob) Andrew Field Regional Aerodrome	CA
CYVK	Vernon Airport	CA
CYVM	Qikiqtarjuaq Airport	CA
CYVO	Val-d'Or Airport	CA
CYVP	Kuujjuaq Airport	CA
CYVQ	Norman Wells Airport	CA
CYVR	Vancouver International Airport	CA
CYVV	Wiarton Airport	CA
CYVZ	Deer Lake Airport	CA
CYWA	Petawawa Airport	CA
CYWG	Winnipeg / James Armstrong Richardson International Airport	CA
CYWJ	Déline Airport	CA
CYWK	Wabush Airport	CA
CYWL	Williams Lake Airport	CA
CYWP	Webequie Airport	CA
CYWY	Wrigley Airport	CA
CYXC	Cranbrook/Canadian Rockies International Airport	CA
CYXE	Saskatoon John G. Diefenbaker International Airport	CA
CYXH	Medicine Hat Regional Airport	CA
CYXJ	Fort St John Airport	CA
CYXK	Rimouski Airport	CA
CYXL	Sioux Lookout Airport	CA
CYXN	Whale Cove Airport	CA
CYXP	Pangnirtung Airport	CA
CYXQ	Beaver Creek Airport	CA
CYXR	Earlton (Timiskaming Regional) Airport	CA
CYXS	Prince George Airport	CA
CYXT	Northwest Regional Airport Terrace-Kitimat	CA
CYXU	London Airport	CA
CYXX	Abbotsford International Airport	CA
CYXY	Whitehorse / Erik Nielsen International Airport	CA
CYXZ	Wawa Airport	CA
CYYB	North Bay Jack Garland Airport	CA
CYYC	Calgary International Airport	CA
CYYD	Smithers Airport	CA
CYYE	Fort Nelson Airport	CA
CYYF	Penticton Airport	CA
CYYG	Charlottetown Airport	CA
CYYH	Taloyoak Airport	CA
CYYJ	Victoria International Airport	CA
CYYL	Lynn Lake Airport	CA
CYYN	Swift Current Airport	CA
CYYQ	Churchill Airport	CA
CYYR	Goose Bay Airport	CA
CYYT	St. John's International Airport	CA
CYYU	Kapuskasing Airport	CA
CYYW	Armstrong Airport	CA
CYYY	Mont Joli Airport	CA
CYYZ	Lester B. Pearson International Airport	CA
CYZD	Downsview Airport	CA
CYZE	Gore Bay Manitoulin Airport	CA
CYZF	Yellowknife International Airport	CA
CYZG	Salluit Airport	CA
CYZH	Slave Lake Airport	CA
CYZP	Sandspit Airport	CA
CYZR	Chris Hadfield Airport	CA
CYZS	Coral Harbour Airport	CA
CYZT	Port Hardy Airport	CA
CYZU	Whitecourt Airport	CA
CYZV	Sept-Îles Airport	CA
CYZW	Teslin Airport	CA
CYZX	CFB Greenwood	CA
CYZY	Mackenzie Airport	CA
CZAC	York Landing Airport	CA
CZAM	Shuswap Regional Airport	CA
CZBB	Boundary Bay Airport	CA
CZBD	Ilford Airport	CA
CZBF	Bathurst Airport	CA
CZBM	Bromont (Roland Désourdy) Airport	CA
CZEE	Kelsey Airport	CA
CZEM	Eastmain River Airport	CA
CZFA	Faro Airport	CA
CZFD	Fond-Du-Lac Airport	CA
CZFG	Pukatawagan Airport	CA
CZFM	Fort Mcpherson Airport	CA
CZFN	Tulita Airport	CA
CZGF	Grand Forks Airport	CA
CZGI	Gods River Airport	CA
CZGR	Little Grand Rapids Airport	CA
CZJG	Jenpeg Airport	CA
CZJN	Swan River Airport	CA
CZKE	Kashechewan Airport	CA
CZLQ	Thicket Portage Airport	CA
CZMD	Muskrat Dam Airport	CA
CZMN	Pikwitonei Airport	CA
CZMT	Masset Airport	CA
CZNG	Poplar River Airport	CA
CZPB	Sachigo Lake Airport	CA
CZPC	Pincher Creek Airport	CA
CZRJ	Round Lake (Weagamow Lake) Airport	CA
CZSJ	Sandy Lake Airport	CA
CZSN	South Indian Lake Airport	CA
CZST	Stewart Airport	CA
CZTM	Shamattawa Airport	CA
CZUC	Ignace Municipal Airport	CA
CZWH	Lac Brochet Airport	CA
CZWL	Wollaston Lake Airport	CA
DAAB	Blida Airport	DZ
DAAD	Bou Saada Airport	DZ
DAAE	Soummam–Abane Ramdane Airport	DZ
DAAG	Houari Boumediene Airport	DZ
DAAJ	Djanet Inedbirene Airport	DZ
DAAK	Boufarik Air Base	DZ
DAAP	Illizi Takhamalt Airport	DZ
DAAS	Ain Arnat Airport	DZ
DAAT	Aguenar – Hadj Bey Akhamok Airport	DZ
DAAV	Jijel Ferhat Abbas Airport	DZ
DAAY	Mecheria Airport	DZ
DAAZ	Relizane Airport	DZ
DABB	Annaba Rabah Bitat Airport	DZ
DABC	Mohamed Boudiaf International Airport	DZ
DABS	Cheikh Larbi Tébessi Airport	DZ
DABT	Batna Mostefa Ben Boulaid Airport	DZ
DAFH	Hassi R'Mel Airport	DZ
DAOB	Abdelhafid Boussouf Bou Chekif Airport	DZ
DAOF	Tindouf Airport	DZ
DAOI	Chlef Aboubakr Belkaid International Airport	DZ
DAOL	Oran Tafraoui Airport	DZ
DAON	Zenata – Messali El Hadj Airport	DZ
DAOO	Oran Es-Sénia (Ahmed Ben Bella) International Airport	DZ
DAOR	Béchar Boudghene Ben Ali Lotfi Airport	DZ
DAOV	Ghriss Airport	DZ
DAUA	Touat Cheikh Sidi Mohamed Belkebir Airport	DZ
DAUB	Biskra - Mohamed Khider Airport	DZ
DAUE	El Golea Airport	DZ
DAUG	Noumérat - Moufdi Zakaria Airport	DZ
DAUH	Hassi Messaoud-Oued Irara Krim Belkacem Airport	DZ
DAUI	In Salah Airport	DZ
DAUK	Touggourt Sidi Madhi Airport	DZ
DAUL	Laghouat - Molay Ahmed Medeghri Airport	DZ
DAUO	Guemar Airport	DZ
DAUT	Timimoun Airport	DZ
DAUU	Ain Beida Airport	DZ
DAUZ	Zarzaitine - In Aménas Airport	DZ
DBBB	Cadjehoun Airport	BJ
DBC	Baicheng Chang'an Airport	CN
DFFD	Ouagadougou Airport	BF
DFOO	Bobo Dioulasso Airport	BF
DGAA	Kotoka International Airport	GH
DGAH	Ho Airport	GH
DGLE	Tamale Airport	GH
DGSI	Kumasi Airport	GH
DGSN	Sunyani Airport	GH
DGTK	Takoradi Airport	GH
DIAP	Félix-Houphouët-Boigny International Airport	CI
DIBK	Bouaké Airport	CI
DIDL	Daloa Airport	CI
DIKO	Korhogo Airport	CI
DIMN	Man Airport	CI
DISP	San Pedro Airport	CI
DIYO	Yamoussoukro Airport	CI
DNAA	Nnamdi Azikiwe International Airport	NG
DNAI	Akwa Ibom International Airport	NG
DNAK	Akure Airport	NG
DNAS	Asaba International Airport	NG
DNBC	Sir Abubakar Tafawa Balewa International Airport	NG
DNBE	Benin Airport	NG
DNBY	Bayelsa International Airport	NG
DNCA	Margaret Ekpo International Airport	NG
DNEN	Akanu Ibiam International Airport	NG
DNGU	Gusau Airport	NG
DNIB	Ibadan Airport	NG
DNIL	Ilorin International Airport	NG
DNIM	Sam Mbakwe International Airport	NG
DNJO	Yakubu Gowon Airport	NG
DNKA	Kaduna Airport	NG
DNKN	Mallam Aminu International Airport	NG
DNMA	Maiduguri International Airport	NG
DNMK	Makurdi Airport	NG
DNMM	Murtala Muhammed International Airport	NG
DNMN	Minna Airport	NG
DNPO	Port Harcourt International Airport	NG
DNSO	Sadiq Abubakar III International Airport	NG
DNYO	Yola Airport	NG
DNZA	Zaria Airport	NG
DRRM	Maradi Airport	NE
DRRN	Diori Hamani International Airport	NE
DRRT	Tahoua Airport	NE
DRZA	Mano Dayak International Airport	NE
DRZR	Zinder Airport	NE
DTKA	Tabarka-Aïn Draham International Airport	TN
DTMB	Monastir Habib Bourguiba International Airport	TN
DTNH	Enfidha - Hammamet International Airport	TN
DTTA	Tunis Carthage International Airport	TN
DTTB	Bizerte Sidi Ahmed Air Base	TN
DTTD	Remada Air Base	TN
DTTF	Gafsa Ksar International Airport	TN
DTTG	Gabès Matmata International Airport	TN
DTTJ	Djerba Zarzis International Airport	TN
DTTR	El Borma Airport	TN
DTTX	Sfax Thyna International Airport	TN
DTTZ	Tozeur Nefta International Airport	TN
DXNG	Niamtougou International Airport	TG
DXXX	Lomé–Tokoin International Airport	TG
DZ-0016	Amguid Regional Airport	DZ
EBAW	Antwerp International Airport (Deurne)	BE
EBBE	Beauvechain Air Base	BE
EBBL	Kleine Brogel Air Base	BE
EBBR	Brussels Airport	BE
EBCI	Brussels South Charleroi Airport	BE
EBCV	Chièvres Air Base	BE
EBFN	Koksijde Air Base	BE
EBFS	Florennes Air Base	BE
EBKT	Wevelgem Airport	BE
EBLG	Liège Airport	BE
EBOS	Ostend-Bruges International Airport	BE
EDAC	Altenburg-Nobitz Airport	DE
EDAH	Heringsdorf Airport	DE
EDBN	Neubrandenburg Airport	DE
EDBR	Rothenburg/Görlitz Airfield	DE
EDDB	Berlin Brandenburg Airport	DE
EDDC	Dresden Airport	DE
EDDE	Erfurt Airport	DE
EDDF	Frankfurt Airport	DE
EDDG	Münster Osnabrück Airport	DE
EDDH	Hamburg Helmut Schmidt Airport	DE
EDDK	Cologne Bonn Airport	DE
EDDL	Düsseldorf Airport	DE
EDDM	Munich Airport	DE
EDDN	Nuremberg Airport	DE
EDDP	Leipzig/Halle Airport	DE
EDDR	Saarbrücken Airport	DE
EDDS	Stuttgart Airport	DE
EDDV	Hannover Airport	DE
EDDW	Bremen Airport	DE
EDFE	Frankfurt-Egelsbach Airport	DE
EDFH	Frankfurt-Hahn Airport	DE
EDFM	Mannheim-City Airport	DE
EDFZ	Mainz-Finthen Airport	DE
EDGE	Eisenach-Kindel Airport	DE
EDGS	Siegerland Airport	DE
EDHI	Hamburg-Finkenwerder Airport	DE
EDHK	Kiel-Holtenau Airport	DE
EDHL	Lübeck Blankensee Airport	DE
EDJA	Memmingen Allgau Airport	DE
EDLN	Mönchengladbach Airport	DE
EDLP	Paderborn Lippstadt Airport	DE
EDLV	Weeze Airport	DE
EDLW	Dortmund Airport	DE
EDMA	Augsburg Airport	DE
EDMO	Oberpfaffenhofen Airport	DE
EDNY	Friedrichshafen Airport	DE
EDOP	Schwerin Parchim Airport	DE
EDQA	Airport Bamberg-Breitenau	DE
EDQD	Bayreuth Airport	DE
EDQM	Hof-Plauen Airport	DE
EDSB	Karlsruhe Baden-Baden Airport	DE
EDTD	Flugplatz Donaueschingen-Villingen	DE
EDTL	Lahr Airport	DE
EDTY	Adolf Würth Airport	DE
EDUZ	Flugplatz Zerbst	DE
EDVE	Braunschweig-Wolfsburg Airport	DE
EDVK	Kassel-Calden Airport	DE
EDXW	Westerland Sylt Airport	DE
EEEI	Ämari Air Base	EE
EEKA	Kärdla Airport	EE
EEKE	Kuressaare Airport	EE
EEPU	Pärnu Airport	EE
EES	Berenice International Airport / Banas Cape Air Base	EG
EETN	Lennart Meri Tallinn Airport	EE
EETU	Tartu Airport	EE
EFET	Enontekio Airport	FI
EFHA	Halli Airport	FI
EFHK	Helsinki Vantaa Airport	FI
EFIT	Kitee Airport	FI
EFIV	Ivalo Airport	FI
EFJO	Joensuu Airport	FI
EFJY	Jyväskylä Airport	FI
EFKA	Kauhava Airfield	FI
EFKE	Kemi-Tornio Airport	FI
EFKI	Kajaani Airport	FI
EFKJ	Kauhajoki Airfield	FI
EFKK	Kokkola-Pietarsaari Airport	FI
EFKS	Kuusamo Airport	FI
EFKT	Kittilä Airport	FI
EFKU	Kuopio Airport	FI
EFLP	Lappeenranta Airport	FI
EFMA	Mariehamn Airport	FI
EFMI	Mikkeli Airport	FI
EFOU	Oulu Airport	FI
EFPO	Pori Airport	FI
EFPR	Helsinki East-Redstone Airport	FI
EFRO	Rovaniemi Airport	FI
EFSA	Savonlinna Airport	FI
EFSI	Seinäjoki Airport	FI
EFSO	Sodankyla Airport	FI
EFTP	Tampere-Pirkkala Airport	FI
EFTU	Turku Airport	FI
EFUT	Utti Air Base	FI
EFVA	Vaasa Airport	FI
EFVR	Varkaus Airport	FI
EFYL	Ylivieska Airfield	FI
EG-0003	Bilbeis 2 Airfield	EG
EGAA	Belfast International Airport	GB
EGAB	Enniskillen/St Angelo Airport	GB
EGAC	George Best Belfast City Airport	GB
EGAE	City of Derry Airport	GB
EGBB	Birmingham International Airport	GB
EGBE	Coventry Airport	GB
EGBJ	Gloucestershire Airport	GB
EGBN	Nottingham Airport	GB
EGCC	Manchester Airport	GB
EGDC	Royal Marines Base Chivenor Airport	GB
EGDM	MoD Boscombe Down Airport	GB
EGDR	RNAS Culdrose	GB
EGDX	St. Athan Airport	GB
EGDY	RNAS Yeovilton	GB
EGEC	Campbeltown Airport	GB
EGED	Eday Airport	GB
EGFE	Haverfordwest Airport	GB
EGFF	Cardiff International Airport	GB
EGFH	Swansea Airport	GB
EGGD	Bristol Airport	GB
EGGP	Liverpool John Lennon Airport	GB
EGGW	London Luton Airport	GB
EGHH	Bournemouth Airport	GB
EGHI	Southampton Airport	GB
EGHL	Lasham Airfield	GB
EGHQ	Cornwall Airport Newquay	GB
EGJA	Alderney Airport	GG
EGJB	Guernsey Airport	GG
EGJJ	Jersey Airport	JE
EGKA	Shoreham Airport	GB
EGKB	London Biggin Hill Airport	GB
EGKK	London Gatwick Airport	GB
EGLC	London City Airport	GB
EGLF	Farnborough Airport	GB
EGLK	Blackbushe Airport	GB
EGLL	London Heathrow Airport	GB
EGMC	Southend Airport	GB
EGMD	Lydd Airport	GB
EGNC	Carlisle Airport	GB
EGNH	Blackpool International Airport	GB
EGNJ	Humberside Airport	GB
EGNL	Barrow Walney Island Airport	GB
EGNM	Leeds Bradford Airport	GB
EGNO	Warton Aerodrome	GB
EGNR	Hawarden Airport	GB
EGNS	Isle of Man Airport	IM
EGNT	Newcastle Airport	GB
EGNV	Teesside International Airport	GB
EGNX	East Midlands Airport	GB
EGOM	RAF Spadeadam	GB
EGOS	RAF Shawbury	GB
EGOV	Anglesey Airport	GB
EGPA	Kirkwall Airport	GB
EGPB	Sumburgh Airport	GB
EGPC	Wick Airport	GB
EGPD	Aberdeen Dyce Airport	GB
EGPE	Inverness Airport	GB
EGPF	Glasgow International Airport	GB
EGPH	Edinburgh Airport	GB
EGPI	Islay Airport	GB
EGPK	Glasgow Prestwick Airport	GB
EGPL	Benbecula Airport	GB
EGPN	Dundee Airport	GB
EGPO	Stornoway Airport	GB
EGPR	Barra Airport	GB
EGPU	Tiree Airport	GB
EGQL	Leuchars Station Airfield	GB
EGQS	RAF Lossiemouth	GB
EGSC	Cambridge Airport	GB
EGSH	Norwich Airport	GB
EGSS	London Stansted Airport	GB
EGTC	Cranfield Airport	GB
EGTE	Exeter International Airport	GB
EGTK	Oxford (Kidlington) Airport	GB
EGUB	RAF Benson	GB
EGUL	RAF Lakenheath	GB
EGUN	RAF Mildenhall	GB
EGUW	Wattisham Airfield	GB
EGUY	RAF Wyton	GB
EGVA	RAF Fairford	GB
EGVN	RAF Brize Norton	GB
EGVO	RAF Odiham	GB
EGWC	DCAE Cosford Air Base	GB
EGWU	RAF Northolt	GB
EGXC	RAF Coningsby	GB
EGXE	RAF Leeming Air Base	GB
EGXG	Leeds East Airport	GB
EGXH	RAF Honington	GB
EGXP	RAF Scampton	GB
EGXT	RAF Wittering	GB
EGXW	RAF Waddington	GB
EGXZ	RAF Topcliffe	GB
EGYD	RAF Cranwell	GB
EGYE	RAF Barkston Heath	GB
EGYM	RAF Marham	GB
EGYP	Mount Pleasant Airport	FK
EHAM	Amsterdam Airport Schiphol	NL
EHBD	Budel Airfield Kempen	NL
EHBK	Maastricht Aachen Airport	NL
EHDL	Deelen Air Base	NL
EHDP	De Peel Air Base	NL
EHEH	Eindhoven Airport	NL
EHGG	Eelde Airport	NL
EHGR	Gilze Rijen Air Base	NL
EHKD	De Kooy Airfield / Den Helder Naval Air Station	NL
EHLE	Lelystad Airport	NL
EHLW	Leeuwarden Air Base	NL
EHRD	Rotterdam The Hague Airport	NL
EHTW	Twente Airport	NL
EHU	Ezhou Huahu Airport	CN
EHVK	Volkel Air Base	NL
EHWO	Woensdrecht Air Base	NL
EICK	Cork Airport	IE
EICM	Galway Airport	IE
EIDL	Donegal Airport	IE
EIDW	Dublin Airport	IE
EIKN	Ireland West Knock Airport	IE
EIKY	Kerry Airport	IE
EIME	Casement Air Base	IE
EINN	Shannon Airport	IE
EISG	Sligo Airport	IE
EIWF	Waterford Airport	IE
EIWT	Weston Airfield	IE
EKAH	Aarhus Airport	DK
EKBI	Billund Airport	DK
EKCH	Copenhagen Kastrup Airport	DK
EKEB	Esbjerg Airport	DK
EKKA	Karup Airport	DK
EKMB	Lolland Falster Maribo Airport	DK
EKOD	Odense Airport	DK
EKRK	Copenhagen Roskilde Airport	DK
EKRN	Bornholm Airport	DK
EKSB	Sønderborg Airport	DK
EKSN	Sindal Airport	DK
EKSP	Skrydstrup Air Base	DK
EKSV	Skive Airport	DK
EKTS	Thisted Airport	DK
EKVD	Kolding Vamdrup Airfield	DK
EKVG	Vágar Airport	FO
EKVJ	Stauning Airport	DK
EKYT	Aalborg Airport	DK
ELLX	Luxembourg-Findel International Airport	LU
ENAL	Ålesund Airport, Vigra	NO
ENAN	Andøya Airport, Andenes	NO
ENAT	Alta Airport	NO
ENBN	Brønnøysund Airport, Brønnøy	NO
ENBO	Bodø Airport	NO
ENBR	Bergen Airport, Flesland	NO
ENBS	Båtsfjord Airport	NO
ENBV	Berlevåg Airport	NO
ENCN	Kristiansand Airport, Kjevik	NO
ENDU	Bardufoss Airport	NO
ENEN	Engeløy Airport	NO
ENEV	Harstad/Narvik Airport, Evenes	NO
ENFG	Fagernes Airport, Leirin	NO
ENFL	Florø Airport	NO
ENGM	Oslo Airport, Gardermoen	NO
ENHD	Haugesund Airport, Karmøy	NO
ENHF	Hammerfest Airport	NO
ENHV	Honningsvåg Airport, Valan	NO
ENKB	Kristiansund Airport, Kvernberget	NO
ENKR	Kirkenes Airport, Høybuktmoen	NO
ENLK	Leknes Airport	NO
ENMH	Mehamn Airport	NO
ENML	Molde Airport, Årø	NO
ENMS	Mosjøen Airport, Kjærstad	NO
ENNA	Lakselv Airport, Banak	NO
ENNO	Notodden Airport	NO
ENOL	Ørland Airport	NO
ENOV	Ørsta-Volda Airport, Hovden	NO
ENRA	Mo i Rana Airport, Røssvoll	NO
ENRM	Rørvik Airport, Ryum	NO
ENRO	Røros Airport	NO
ENRY	Moss Airport, Rygge	NO
ENSB	Svalbard Airport, Longyear	NO
ENSH	Svolvær Airport, Helle	NO
ENSK	Stokmarknes Airport, Skagen	NO
ENSN	Skien Airport	NO
ENSO	Stord Airport, Sørstokken	NO
ENSR	Sørkjosen Airport	NO
ENSS	Vardø Airport, Svartnes	NO
ENST	Sandnessjøen Airport, Stokka	NO
ENTC	Tromsø Airport, Langnes	NO
ENTO	Sandefjord Airport, Torp	NO
ENVA	Trondheim Airport, Værnes	NO
ENVD	Vadsø Airport	NO
ENY	Yan'an Nanniwan Airport	CN
ENZV	Stavanger Airport, Sola	NO
EPBY	Bydgoszcz Ignacy Jan Paderewski Airport	PL
EPCE	Cewice Air Base	PL
EPDE	Deblin Military Air Base	PL
EPGD	Gdańsk Lech Wałęsa Airport	PL
EPIR	Inowroclaw Military Air Base	PL
EPKK	Kraków John Paul II International Airport	PL
EPKS	Krzesiny Military Air Base	PL
EPKT	Katowice International Airport	PL
EPLB	Lublin Airport	PL
EPLK	Lask Military Air Base	PL
EPLL	Łódź Władysław Reymont Airport	PL
EPLS	Leszno-Strzyzewice Airport	PL
EPLY	Leczyca Military Air Base	PL
EPMB	22nd Air Base	PL
EPMI	Miroslawiec Military Air Base	PL
EPMM	Minsk Mazowiecki Military Air Base	PL
EPMO	Modlin Airport	PL
EPOK	Oksywie Military Air Base	PL
EPPO	Poznań-Ławica Airport	PL
EPPW	Powidz Military Air Base	PL
EPRA	Radom Airport	PL
EPRZ	Rzeszów-Jasionka Airport	PL
EPSC	Szczecin-Goleniów "Solidarność" Airport	PL
EPSN	Swidwin Military Air Base	PL
EPSY	Olsztyn-Mazury Airport	PL
EPTM	Tomaszow Mazowiecki Military Air Base	PL
EPWA	Warsaw Chopin Airport	PL
EPWR	Copernicus Wrocław Airport	PL
EPZG	Zielona Góra-Babimost Airport	PL
ES-0109	Folgueroles Airfield	ES
ESCF	Malmen Air Base	SE
ESDF	Ronneby Airport	SE
ESFR	Råda Air Base	SE
ESGG	Gothenburg-Landvetter Airport	SE
ESGJ	Jönköping Airport	SE
ESGP	Gothenburg City Airport	SE
ESGR	Skövde Airport	SE
ESGT	Trollhättan-Vänersborg Airport	SE
ESIB	Såtenäs Air Base	SE
ESKK	Karlskoga Airport	SE
ESKM	Mora Airport	SE
ESKN	Stockholm Skavsta Airport	SE
ESKS	Scandinavian Mountains Airport	SE
ESMK	Kristianstad Airport	SE
ESMQ	Kalmar Airport	SE
ESMS	Malmö Sturup Airport	SE
ESMT	Halmstad Airport	SE
ESMX	Växjö Kronoberg Airport	SE
ESND	Sveg Airport	SE
ESNG	Gällivare Airport	SE
ESNK	Kramfors-Sollefteå Höga Kusten Airport	SE
ESNL	Lycksele Airport	SE
ESNN	Sundsvall-Härnösand Airport	SE
ESNO	Örnsköldsvik Airport	SE
ESNQ	Kiruna Airport	SE
ESNS	Skellefteå Airport	SE
ESNU	Umeå Airport	SE
ESNV	Vilhelmina South Lapland Airport	SE
ESNX	Arvidsjaur Airport	SE
ESNY	Söderhamn Airport	SE
ESNZ	Åre Östersund Airport	SE
ESOE	Örebro Airport	SE
ESOH	Hagfors Airport	SE
ESOK	Karlstad Airport	SE
ESOW	Stockholm Västerås Airport	SE
ESPA	Luleå Airport	SE
ESSA	Stockholm-Arlanda Airport	SE
ESSB	Stockholm-Bromma Airport	SE
ESSD	Dala Airport	SE
ESSK	Gävle Sandviken Airport	SE
ESSL	Linköping City Airport	SE
ESSP	Norrköping Airport	SE
ESST	Torsby Airport	SE
ESSU	Eskilstuna Airport	SE
ESSV	Visby Airport	SE
ESTA	Ängelholm-Helsingborg Airport	SE
ESTL	Ljungbyhed Airport	SE
ESUD	Storuman Airport	SE
ESUP	Pajala Airport	SE
ESUT	Hemavan Airport	SE
ETAD	Spangdahlem Air Base	DE
ETAR	Ramstein Air Base	DE
ETHB	Bückeburg Air Base	DE
ETHC	Celle Army Airfield	DE
ETHF	Fritzlar Army Airfield	DE
ETHL	Laupheim Air Base	DE
ETHN	Niederstetten Army Air Base	DE
ETHS	Fassberg Air Base	DE
ETIC	Grafenwohr Army Air Field	DE
ETIH	Hohenfels Army Airfield	DE
ETMN	Nordholz Naval Airbase	DE
ETND	Diepholz Air Base	DE
ETNG	Geilenkirchen Air Base	DE
ETNH	Hohn Air Base	DE
ETNL	Rostock-Laage Airport	DE
ETNN	Nörvenich Air Base	DE
ETNS	Schleswig Air Base	DE
ETNT	Wittmundhafen Air Base	DE
ETNW	Wunstorf Air Base	DE
ETOU	Wiesbaden Army Airfield	DE
ETSB	Büchel Air Base	DE
ETSH	Holzdorf Air Base	DE
ETSI	Ingolstadt Manching Airport	DE
ETSL	Lechfeld Air Base	DE
ETSN	Neuburg AFB	DE
EVDA	Daugavpils International Airport	LV
EVKA	Jēkabpils Air Base	LV
EVLA	Liepāja International Airport	LV
EVRA	Riga International Airport	LV
EVTA	Jūrmala Airport	LV
EVVA	Ventspils International Airport	LV
EYKA	Kaunas International Airport	LT
EYKD	Kėdainiai Air Base	LT
EYPA	Palanga International Airport	LT
EYPP	Panevėžys Air Base	LT
EYSA	Šiauliai International Airport	LT
EYSB	Barysiai Airfield	LT
EYVI	Vilnius International Airport	LT
FAAB	Alexander Bay Airport	ZA
FAAG	Aggeneys Airport	ZA
FABE	Bisho Airport	ZA
FABL	Bram Fischer International Airport	ZA
FABR	Barberton Airport	ZA
FACT	Cape Town International Airport	ZA
FAEL	Ben Schoeman Airport	ZA
FAEO	Ermelo Airport	ZA
FAFB	Ficksburg Sentraoes Airport	ZA
FAGC	Grand Central Airport	ZA
FAGG	George Airport	ZA
FAGM	Rand Airport	ZA
FAHR	Harrismith Airport	ZA
FAKD	P C Pelser Airport	ZA
FAKM	Kimberley Airport	ZA
FAKN	Kruger Mpumalanga International Airport	ZA
FAKU	Johan Pienaar Airport	ZA
FAKZ	Kleinsee Airport	ZA
FALA	Lanseria International Airport	ZA
FALC	Lime Acres Finsch Mine Airport	ZA
FALE	King Shaka International Airport	ZA
FALW	Langebaanweg Airport	ZA
FALY	Ladysmith Airport	ZA
FAMD	Malamala Airport	ZA
FAMG	Margate Airport	ZA
FAMM	Mmabatho International Airport	ZA
FAMN	Riverside Airport	ZA
FAMS	Morningside Farm Airport	ZA
FAMU	Mkuze Airport	ZA
FANC	Newcastle Airport	ZA
FAOH	Oudtshoorn Airport	ZA
FAOR	OR Tambo International Airport	ZA
FAPE	Chief Dawid Stuurman International Airport	ZA
FAPG	Plettenberg Bay Airport	ZA
FAPH	Hendrik Van Eck Airport	ZA
FAPI	Pietersburg Municipal Airport	ZA
FAPJ	Port St Johns Airport	ZA
FAPM	Pietermaritzburg Airport	ZA
FAPP	Polokwane International Airport	ZA
FAPS	Potchefstroom Airport	ZA
FAQT	Queenstown Airport	ZA
FARB	Richards Bay Airport	ZA
FARG	Rustenburg Airport	ZA
FARS	Robertson Airport	ZA
FASB	Springbok Airport	ZA
FASC	Secunda Airport	ZA
FASD	Saldanha/Vredenburg Airport	ZA
FASS	Sishen Airport	ZA
FASZ	Skukuza Airport	ZA
FATZ	Tzaneen Airport	ZA
FAUL	Prince Mangosuthu Buthelezi Airport	ZA
FAUP	Pierre Van Ryneveld Airport	ZA
FAUT	K. D. Matanzima Airport	ZA
FAVB	Vryburg Airport	ZA
FAVG	Virginia Airport	ZA
FAVR	Vredendal Airport	ZA
FAVV	Vereeniging Airport	ZA
FAWB	Wonderboom Airport	ZA
FAWK	Waterkloof Air Force Base	ZA
FAYP	Ysterplaat Air Force Base	ZA
FBFT	P G Matante Intl	BW
FBJW	Jwaneng Airport	BW
FBKE	Kasane Airport	BW
FBMN	Maun Airport	BW
FBSK	Sir Seretse Khama International Airport	BW
FBSN	Sua Pan Airport	BW
FBSP	Selebi Phikwe Airport	BW
FCBB	Maya-Maya Airport	CG
FCOD	Oyo Ollombo Airport	CG
FCOO	Owando Airport	CG
FCOU	Ouesso Airport	CG
FCPL	Ngot Nzoungou Airport	CG
FCPP	Antonio Agostinho-Neto International Airport	CG
FDMS	Matsapha Airport	SZ
FDSK	King Mswati III International Airport	SZ
FEFF	Bangui M'Poko International Airport	CF
FEFT	Berbérati Airport	CF
FGBT	Bata Airport	GQ
FGSL	Malabo Airport	GQ
FHAW	RAF Ascension Island	SH
FIMP	Sir Seewoosagur Ramgoolam International Airport	MU
FIMR	Sir Charles Gaetan Duval Airport	MU
FJDG	Diego Garcia Naval Support Facility	IO
FKKC	Tiko Airport	CM
FKKD	Douala International Airport	CM
FKKL	Salak Airport	CM
FKKM	Foumban Nkounja Airport	CM
FKKN	N'Gaoundéré Airport	CM
FKKR	Garoua International Airport	CM
FKKU	Bafoussam Airport	CM
FKKV	Bamenda Airport	CM
FKKY	Yaoundé Airport	CM
FKYS	Yaoundé Nsimalen International Airport	CM
FLKE	Kasompe Airport	ZM
FLLC	Lusaka City Airport	ZM
FLLI	Harry Mwanga Nkumbula International Airport	ZM
FLLS	Kenneth Kaunda International Airport	ZM
FLMF	Mfuwe Airport	ZM
FLMG	Mongu Airport	ZM
FLND	Simon Mwansa Kapwepwe International Airport	ZM
FLSO	Southdowns Airport	ZM
FMCH	Prince Said Ibrahim International Airport	KM
FMCI	Mohéli Bandar Es Eslam Airport	KM
FMCV	Ouani Airport	KM
FMCZ	Dzaoudzi Pamandzi International Airport	YT
FMEE	Roland Garros Airport	RE
FMEP	Pierrefonds Airport	RE
FMMI	Ivato Airport	MG
FMMN	Miandrivazo Airport	MG
FMMS	Sainte Marie Airport	MG
FMMT	Toamasina Ambalamanasy Airport	MG
FMMV	Morondava Airport	MG
FMNA	Arrachart Airport	MG
FMNC	Mananara Nord Airport	MG
FMND	Andapa Airport	MG
FMNH	Antsirabe Airport	MG
FMNL	Analalava Airport	MG
FMNM	Amborovy Airport	MG
FMNN	Fascene Airport	MG
FMNQ	Besalampy Airport	MG
FMNR	Maroantsetra Airport	MG
FMNS	Sambava Airport	MG
FMNV	Vohemar Airport	MG
FMNW	Ambalabe Airport	MG
FMSD	Tôlanaro Airport	MG
FMSF	Fianarantsoa Airport	MG
FMSK	Manakara Airport	MG
FMSM	Mananjary Airport	MG
FMSR	Morombe Airport	MG
FMST	Toliara Airport	MG
FNBC	Mbanza Congo Airport	AO
FNBG	Benguela 17th of September Airport	AO
FNCA	Cabinda Airport	AO
FNCT	Catumbela Airport	AO
FNDU	Dundo Airport	AO
FNGI	Ngjiva Pereira Airport	AO
FNHU	Nova Lisboa Airport	AO
FNKU	Kuito Airport	AO
FNLU	Quatro de Fevereiro International Airport	AO
FNMA	Malanje Airport	AO
FNME	Menongue Airport	AO
FNMO	Welwitschia Mirabilis International Airport	AO
FNNG	Negage Airport	AO
FNPA	Porto Amboim Airport	AO
FNSA	Saurimo Airport	AO
FNSO	Soyo Airport	AO
FNSU	Sumbe Airport	AO
FNUB	Lubango Airport	AO
FNUE	Luena Airport	AO
FNUG	Uige Airport	AO
FNXA	Xangongo Airport	AO
FOGK	Koulamoutou Mabimbi Airport	GA
FOGM	Mouilla Ville Airport	GA
FOGO	Oyem Airport	GA
FOGQ	Okondja Airport	GA
FOGR	Lambarene Airport	GA
FOOB	Bitam Airport	GA
FOOG	Port Gentil Airport	GA
FOOH	Omboue Hospital Airport	GA
FOOK	Makokou Airport	GA
FOOL	Libreville Leon M'ba International Airport	GA
FOON	M'Vengue El Hadj Omar Bongo Ondimba International Airport	GA
FPPR	Principe Airport	ST
FPST	São Tomé International Airport	ST
FQBR	Beira Airport	MZ
FQCH	Chimoio Airport	MZ
FQIN	Inhambane Airport	MZ
FQLC	Lichinga Airport	MZ
FQMA	Maputo Airport	MZ
FQMD	Mueda Airport	MZ
FQMP	Mocímboa da Praia Airport	MZ
FQNP	Nampula Airport	MZ
FQPB	Pemba Airport	MZ
FQQL	Quelimane Airport	MZ
FQTT	Chingozi Airport	MZ
FQVL	Vilankulo Airport	MZ
FSIA	Seychelles International Airport	SC
FSPP	Praslin Airport	SC
FTFY	Ouadi Doum Air Base	TD
FTTC	Abeche Airport	TD
FTTD	Moundou Airport	TD
FTTJ	N'Djamena International Airport	TD
FTTY	Faya Largeau Airport	TD
FVBU	Joshua Mqabuko Nkomo International Airport	ZW
FVCZ	Buffalo Range Airport	ZW
FVFA	Victoria Falls International Airport	ZW
FVHA	Robert Gabriel Mugabe International Airport	ZW
FVKB	Kariba International Airport	ZW
FVMT	Mutoko Airport	ZW
FVMV	Masvingo International Airport	ZW
FVTL	Gweru - Thornhill Air Base	ZW
FVWN	Hwange National Park Airport	ZW
FWCL	Chileka International Airport	MW
FWDW	Dwangwa Airport	MW
FWKA	Karonga Airport	MW
FWKI	Lilongwe International Airport	MW
FWMG	Mangochi Airport	MW
FWUU	Mzuzu Airport	MW
FXMM	Moshoeshoe I International Airport	LS
FYAR	Arandis Airport	NA
FYGF	Grootfontein Airport	NA
FYKT	Keetmanshoop Airport	NA
FYLZ	Luderitz Airport	NA
FYML	Mariental Airport	NA
FYOA	Ondangwa Airport	NA
FYOG	Oranjemund Airport	NA
FYRU	Rundu Airport	NA
FYTM	Tsumeb Airport	NA
FYWB	Walvis Bay Airport	NA
FYWE	Eros Airport	NA
FYWH	Hosea Kutako International Airport	NA
FZAA	Ndjili International Airport	CD
FZAB	Ndolo Airport	CD
FZBO	Bandundu Airport	CD
FZCA	Kikwit Airport	CD
FZEA	Mbandaka Airport	CD
FZFD	Gbadolite Airport	CD
FZFK	Gemena Airport	CD
FZGA	Lisala Airport	CD
FZIC	Bangoka International Airport	CD
FZJH	Matari Airport	CD
FZKA	Bunia Airport	CD
FZKJ	Buta Zega Airport	CD
FZMA	Bukavu Kavumu Airport	CD
FZNA	Goma International Airport	CD
FZOA	Kindu Airport	CD
FZQA	Lubumbashi International Airport	CD
FZQM	Kolwezi Airport	CD
FZRF	Kalemie Airport	CD
FZSA	Kamina Air Base	CD
FZUA	Kananga Airport	CD
FZWA	Mbuji Mayi Airport	CD
GABS	Modibo Keita International Airport	ML
GAGO	Gao Airport	ML
GAKY	Kayes Dag Dag Airport	ML
GAMB	Mopti Ambodédjo International Airport	ML
GATB	Timbuktu Airport	ML
GBYD	Banjul International Airport	GM
GCFV	Fuerteventura Airport	ES
GCHI	El Hierro Airport	ES
GCLA	La Palma Airport	ES
GCLP	Gran Canaria Airport	ES
GCRR	César Manrique-Lanzarote Airport	ES
GCTS	Tenerife Sur Airport	ES
GCXO	Tenerife Norte-Ciudad de La Laguna Airport	ES
GE-0007	Ozurgeti Air Base	GE
GE-0010	Senaki Air Base	GE
GEML	Melilla Airport	ES
GFBO	Bo Airport	SL
GFKE	Kenema Airport	SL
GFLL	Lungi International Airport	SL
GFYE	Yengema Airport	SL
GGOV	Osvaldo Vieira International Airport	GW
GLMR	Spriggs Payne Airport	LR
GLRB	Roberts International Airport	LR
GMAD	Al Massira Airport	MA
GMAT	Tan Tan Airport	MA
GMFB	Bouarfa Airport	MA
GMFF	Fes Saïss International Airport	MA
GMFK	Moulay Ali Cherif Airport	MA
GMFM	Bassatine Airport	MA
GMFO	Oujda Angads Airport	MA
GMMA	Smara Airport	EH
GMME	Rabat-Salé Airport	MA
GMMH	Dakhla Airport	EH
GMMI	Essaouira-Mogador Airport	MA
GMML	Hassan I Airport	EH
GMMN	Mohammed V International Airport	MA
GMMW	Nador Al Aaroui International Airport	MA
GMMX	Menara Airport	MA
GMMY	Kenitra Air Base	MA
GMMZ	Ouarzazate Airport	MA
GMQ	Golog Maqên Airport	CN
GMTA	Cherif Al Idrissi Airport	MA
GMTN	Sania Ramel Airport	MA
GMTT	Tangier Ibn Battuta Airport	MA
GOBD	Blaise Diagne International Airport	SN
GOGG	Ziguinchor Airport	SN
GOGS	Cap Skirring Airport	SN
GOOK	Kaolack Airport	SN
GOOY	Léopold Sédar Senghor International Airport	SN
GOSM	Ouro Sogui Airport	SN
GOSS	Saint Louis Airport	SN
GOTB	Bakel Airport	SN
GOTK	Kédougou Airport	SN
GOTT	Tambacounda Airport	SN
GQNO	Nouakchott–Oumtounsy International Airport	MR
GQPA	Atar International Airport	MR
GQPP	Nouadhibou International Airport	MR
GUCY	Conakry International Airport	GN
GVAC	Amílcar Cabral International Airport	CV
GVBA	Rabil Airport	CV
GVMA	Maio Airport	CV
GVNP	Praia International Airport	CV
GVSN	Preguiça Airport	CV
GVSV	São Pedro Airport	CV
HAAB	Addis Ababa Bole International Airport	ET
HAAM	Arba Minch Airport	ET
HAAX	Axum Airport	ET
HABD	Bahir Dar Airport	ET
HADR	Aba Tenna Dejazmach Yilma International Airport	ET
HAGM	Gambela Airport	ET
HAGN	Gondar Airport	ET
HAGO	Gode Airport	ET
HAHM	Harar Meda Airport	ET
HAJJ	Wilwal International Airport	ET
HAJM	Jimma Airport	ET
HAKD	Kebri Dahar Airport	ET
HALA	Hawassa International Airport	ET
HAMK	Alula Aba Nega Airport	ET
HASO	Asosa Airport	ET
HBBA	Bujumbura Melchior Ndadaye International Airport	BI
HCMH	Egal International Airport	SO
HCMI	Berbera Airport	SO
HCMK	Kismayo Airport	SO
HCMM	Aden Adde International Airport	SO
HDAM	Djibouti-Ambouli Airport	DJ
HE16	Birma Air Base	EG
HE28	Gebel El Basur Air Base	EG
HE32	Al Mansurah Airbase	EG
HE35	Abu Suwayr Air Base	EG
HE36	Jafjafa Well Airfield	EG
HE37	Bilbeis Air Base	EG
HE42	Quesna Airport	EG
HEAL	El Alamein International Airport	EG
HEAR	El Arish International Airport	EG
HEAT	Asyut International Airport	EG
HEAZ	Almaza Air Force Base	EG
HEBA	Borj El Arab International Airport	EG
HEBL	Abu Simbel Airport	EG
HEBS	Bani Sweif Air Base	EG
HECA	Cairo International Airport	EG
HECP	Capital International Airport	EG
HECW	Cairo West Air Base	EG
HEGN	Hurghada International Airport	EG
HEGR	El Jora Airport	EG
HEGS	Jiyanklis Air Base	EG
HEIS	Ismailia Air Base	EG
HELX	Luxor International Airport	EG
HEMA	Marsa Alam International Airport	EG
HEMM	Marsa Matruh International Airport	EG
HEPS	Port Said International Airport	EG
HESC	Saint Catherine International Airport	EG
HESG	Suhaj Mubarak International Airport	EG
HESH	Sharm El Sheikh International Airport	EG
HESN	Aswan International Airport	EG
HESX	Sphinx International Airport	EG
HETB	Taba International Airport	EG
HHAS	Asmara International Airport	ER
HHMS	Massawa International Airport	ER
HHSB	Assab International Airport	ER
HIA	Huai'an Lianshui International Airport	CN
HJJJ	Juba International Airport	SS
HKAM	Amboseli Airport	KE
HKEL	Eldoret International Airport	KE
HKJK	Jomo Kenyatta International Airport	KE
HKKI	Kisumu Airport	KE
HKKT	Kitale Airport	KE
HKLK	Lokichoggio Airport	KE
HKLO	Lodwar Airport	KE
HKLU	Manda Airport	KE
HKML	Malindi Airport	KE
HKMO	Moi International Airport	KE
HKMS	Mara Serena Lodge Airstrip	KE
HKNW	Nairobi Wilson Airport	KE
HKNY	Nanyuki Airport	KE
HKRE	Moi Air Base	KE
HKWJ	Wajir Airport	KE
HL56	Matan al-Sarra Air Base	LY
HL68	Bombah Airport	LY
HL77	Okba Ibn Nafa Air Base	LY
HLGD	Sirt International Airport / Ghardabiya Airbase	LY
HLGT	Ghat Airport	LY
HLKF	Kufra Airport	LY
HLLB	Benina International Airport	LY
HLLM	Mitiga International Airport	LY
HLLQ	Al Abraq International Airport	LY
HLLS	Sabha Airport	LY
HLMB	Marsa al Brega Airport	LY
HLTD	Ghadames East Airport	LY
HRYG	Gisenyi Airport	RW
HRYR	Kigali International Airport	RW
HRZA	Kamembe Airport	RW
HSDN	Dongola Airport	SD
HSFA	Paloich Airport	SS
HSFS	El Fasher Airport	SD
HSKA	Kassala Airport	SD
HSMN	Merowe Airport	SD
HSNN	Nyala Airport	SD
HSOB	El-Obeid Airport	SD
HSPN	Port Sudan New International Airport	SD
HSSG	Sabera Geneina Airport	SD
HSSK	Khartoum International Airport	SD
HSSM	Malakal Airport	SS
HSWW	Wau Airport	SS
HTAR	Arusha Airport	TZ
HTDA	Julius Nyerere International Airport	TZ
HTDO	Dodoma Airport	TZ
HTGW	Songwe Airport	TZ
HTIR	Iringa Airport	TZ
HTKJ	Kilimanjaro International Airport	TZ
HTLM	Lake Manyara Airport	TZ
HTMT	Mtwara Airport	TZ
HTMW	Mwanza Airport	TZ
HTPE	Pemba Airport	TZ
HTTG	Tanga Airport	TZ
HTZA	Abeid Amani Karume International Airport	TZ
HU-0002	Kalocsa-Foktő Airport	HU
HUAR	Arua Airport	UG
HUEN	Entebbe International Airport	UG
HUGU	Gulu Airport	UG
HUSO	Soroti Airport	UG
HZU	Chengdu Huaizhou Airport	CN
IBL	Indigo Bay Lodge Airport	MZ
ID-0274	Sangia Nibandera Airport	ID
ID-0277	Kediri Airport	ID
ID-ZGP	Bilogai-Sugapa Airport	ID
IN-0011	Jakkur Aerodrome	IN
IN-0277	Mopa International Airport	IN
IN-0308	Itanagar Donyi Polo Hollongi Airport	IN
IQ-0016	H1 New Air Base	IQ
IQ-0017	H2 Air Base	IQ
IQ-0018	H3 Air Base	IQ
IQ-0020	H3 Northwest AFB	IQ
IQ-0021	H3 Southwest Air Base	IQ
IQ-0024	Jalibah Southeast Air Base	IQ
IQ-0030	Kut Al Hayy East Air Base	IQ
IQ-0034	Qalat Salih Air Base	IQ
IQ-0039	Rasheed Air Base	IQ
IQ-0040	Ruwayshid Air Base	IQ
IQ-0042	Sahl Sinjar Air Base	IQ
IQ-0044	Salum Air Base	IQ
IQ-0045	Samarra East Air Base / Dhuluiya Airport	IQ
IQ-0051	Tal Ashtah New Air Base	IQ
IQ-0054	Tuz Khurmatu Air Base	IQ
IQ-0055	Wadi Al Khirr New Air Base	IQ
ISG	New Ishigaki Airport	JP
JGD	Jiagedaqi Airport	CN
JIQ	Qianjiang Wulingshan Airport	CN
JJD	Jericoacoara - Comandante Ariston Pessoa Regional Airport	BR
JNZ	Jinzhou Bay Airport	CN
JO-0002	King Feisal Air Base	JO
K61B	Boulder City Municipal Airport	US
K67L	Mesquite International Airport	US
K79J	South Alabama Regional At Bill Benton Field Airport	US
KABE	Lehigh Valley International Airport	US
KABI	Abilene Regional Airport	US
KABQ	Albuquerque International Sunport	US
KABR	Aberdeen Regional Airport	US
KABY	Southwest Georgia Regional Airport	US
KACK	Nantucket Memorial Airport	US
KACT	Waco Regional Airport	US
KACV	California Redwood Coast-Humboldt County Airport	US
KACY	Atlantic City International Airport	US
KADW	Joint Base Andrews	US
KAEX	Alexandria International Airport	US
KAFW	Perot Field/Fort Worth Alliance Airport	US
KAGC	Allegheny County Airport	US
KAGS	Augusta Regional At Bush Field	US
KAHN	Athens Ben Epps Airport	US
KAKR	Akron Executive Airport	US
KALB	Albany International Airport	US
KALI	Alice International Airport	US
KALM	Alamogordo White Sands Regional Airport	US
KALN	St Louis Regional Airport	US
KALO	Waterloo Regional Airport	US
KALS	San Luis Valley Regional Airport/Bergman Field	US
KALW	Walla Walla Regional Airport	US
KAMA	Rick Husband Amarillo International Airport	US
KANB	Anniston Regional Airport	US
KAND	Anderson Regional Airport	US
KAOO	Altoona Blair County Airport	US
KAPA	Centennial Airport	US
KAPF	Naples Municipal Airport	US
KAPG	Phillips Army Air Field	US
KAPN	Alpena County Regional Airport	US
KARA	Acadiana Regional Airport	US
KART	Watertown International Airport	US
KASE	Aspen-Pitkin County Airport (Sardy Field)	US
KAST	Astoria Regional Airport	US
KATL	Hartsfield Jackson Atlanta International Airport	US
KATY	Watertown Regional Airport	US
KAUG	Augusta State Airport	US
KAUS	Austin Bergstrom International Airport	US
KAUW	Wausau Downtown Airport	US
KAVL	Asheville Regional Airport	US
KAVP	Wilkes Barre Scranton International Airport	US
KAXN	Chandler Field	US
KAZO	Kalamazoo Battle Creek International Airport	US
KBAB	Beale Air Force Base	US
KBAD	Barksdale Air Force Base	US
KBAF	Westfield-Barnes Regional Airport	US
KBAK	Columbus Municipal Airport	US
KBAZ	New Braunfels Municipal Airport	US
KBBD	Curtis Field	US
KBCE	Bryce Canyon Airport	US
KBDE	Baudette International Airport	US
KBDL	Bradley International Airport	US
KBDR	Igor I Sikorsky Memorial Airport	US
KBED	Laurence G Hanscom Field	US
KBFD	Bradford Regional Airport	US
KBFF	Western Neb. Rgnl/William B. Heilig Airport	US
KBFI	Boeing Field King County International Airport	US
KBFL	Meadows Field	US
KBFM	Mobile Downtown Airport	US
KBGM	Greater Binghamton/Edwin A Link field	US
KBGR	Bangor International Airport	US
KBHB	Hancock County-Bar Harbor Airport	US
KBHM	Birmingham-Shuttlesworth International Airport	US
KBIF	Biggs Army Air Field (Fort Bliss)	US
KBIH	Eastern Sierra Regional Airport	US
KBIL	Billings Logan International Airport	US
KBIS	Bismarck Municipal Airport	US
KBIX	Keesler Air Force Base	US
KBJC	Rocky Mountain Metropolitan Airport	US
KBJI	Bemidji Regional Airport	US
KBKE	Baker City Municipal Airport	US
KBKF	Buckley Space Force Base	US
KBKL	Burke Lakefront Airport	US
KBKW	Raleigh County Memorial Airport	US
KBLF	Mercer County Airport	US
KBLH	Blythe Airport	US
KBLI	Bellingham International Airport	US
KBLV	Scott AFB/Midamerica Airport	US
KBMG	Monroe County Airport	US
KBMI	Central Illinois Regional Airport at Bloomington-Normal	US
KBNA	Nashville International Airport	US
KBNO	Burns Municipal Airport	US
KBOI	Boise Air Terminal/Gowen Field	US
KBOS	Logan International Airport	US
KBPI	Miley Memorial Field	US
KBPK	Ozark Regional Airport	US
KBPT	Jack Brooks Regional Airport	US
KBQK	Brunswick Golden Isles Airport	US
KBRD	Brainerd Lakes Regional Airport	US
KBRL	Southeast Iowa Regional Airport	US
KBRO	Brownsville South Padre Island International Airport	US
KBTL	Battle Creek Executive Airport at Kellogg Field	US
KBTM	Bert Mooney Airport	US
KBTR	Baton Rouge Metropolitan Airport	US
KBTV	Burlington International Airport	US
KBUF	Buffalo Niagara International Airport	US
KBUR	Bob Hope Airport	US
KBVI	Beaver County Airport	US
KBVY	Beverly Regional Airport	US
KBWG	Bowling Green Warren County Regional Airport	US
KBWI	Baltimore/Washington International Thurgood Marshall Airport	US
KBYH	Arkansas International Airport	US
KBYI	Burley Municipal Airport	US
KBYS	Bicycle Lake Army Air Field	US
KBZN	Gallatin Field	US
KCAE	Columbia Metropolitan Airport	US
KCAK	Akron Canton Regional Airport	US
KCAR	Caribou Municipal Airport	US
KCBM	Columbus Air Force Base	US
KCCY	Northeast Iowa Regional Airport	US
KCDC	Cedar City Regional Airport	US
KCDR	Chadron Municipal Airport	US
KCDS	Childress Municipal Airport	US
KCEC	Jack Mc Namara Field Airport	US
KCEF	Westover Metropolitan Airport / Westover Air Reserve Base	US
KCEW	Bob Sikes Airport	US
KCGF	Cuyahoga County Airport	US
KCGI	Cape Girardeau Regional Airport	US
KCHA	Chattanooga Metropolitan Airport (Lovell Field)	US
KCHO	Charlottesville Albemarle Airport	US
KCHS	Charleston International Airport	US
KCID	The Eastern Iowa Airport	US
KCIU	Chippewa County International Airport	US
KCKB	North Central West Virginia Airport	US
KCLE	Cleveland Hopkins International Airport	US
KCLL	Easterwood Field	US
KCLM	William R Fairchild International Airport	US
KCLT	Charlotte Douglas International Airport	US
KCMA	Camarillo International Airport	US
KCMH	John Glenn Columbus International Airport	US
KCMI	University of Illinois Willard Airport	US
KCMX	Houghton County Memorial Airport	US
KCNM	Cavern City Air Terminal	US
KCNU	Chanute Martin Johnson Airport	US
KCOD	Yellowstone Regional Airport	US
KCOE	Coeur D'Alene - Pappy Boyington Field	US
KCOF	Patrick Space Force Base	US
KCON	Concord Municipal Airport	US
KCOS	City of Colorado Springs Municipal Airport	US
KCOU	Columbia Regional Airport	US
KCPF	Wendell H Ford Airport	US
KCPR	Casper-Natrona County International Airport	US
KCRE	Grand Strand Airport	US
KCRG	Jacksonville Executive at Craig Airport	US
KCRP	Corpus Christi International Airport	US
KCRQ	McClellan-Palomar Airport	US
KCRW	Yeager Airport	US
KCSG	Columbus Metropolitan Airport	US
KCSV	Crossville Memorial Whitson Field	US
KCTB	Cut Bank International Airport	US
KCUB	Jim Hamilton L.B. Owens Airport	US
KCVG	Cincinnati Northern Kentucky International Airport	US
KCVO	Corvallis Municipal Airport	US
KCVS	Cannon Air Force Base	US
KCWA	Central Wisconsin Airport	US
KCXO	Conroe-North Houston Regional Airport	US
KCYS	Cheyenne Regional Jerry Olson Field	US
KDAA	Davison Army Air Field	US
KDAB	Daytona Beach International Airport	US
KDAG	Barstow Daggett Airport	US
KDAL	Dallas Love Field	US
KDAN	Danville Regional Airport	US
KDAY	James M Cox Dayton International Airport	US
KDBQ	Dubuque Regional Airport	US
KDCA	Ronald Reagan Washington National Airport	US
KDDC	Dodge City Regional Airport	US
KDEC	Decatur Airport	US
KDEN	Denver International Airport	US
KDET	Coleman A. Young Municipal Airport	US
KDFW	Dallas Fort Worth International Airport	US
KDHN	Dothan Regional Airport	US
KDHT	Dalhart Municipal Airport	US
KDIK	Dickinson Theodore Roosevelt Regional Airport	US
KDLF	Laughlin Air Force Base	US
KDLH	Duluth International Airport	US
KDLS	Columbia Gorge Regional Airport	US
KDMA	Davis Monthan Air Force Base	US
KDMN	Deming Municipal Airport	US
KDNL	Daniel Field	US
KDOV	Dover Air Force Base	US
KDPA	Dupage Airport	US
KDRA	Desert Rock Airport	US
KDRI	Beauregard Regional Airport	US
KDRT	Del Rio International Airport	US
KDSM	Des Moines International Airport	US
KDTW	Detroit Metropolitan Wayne County Airport	US
KDUG	Bisbee Douglas International Airport	US
KDUJ	DuBois Regional Airport	US
KDYS	Dyess Air Force Base	US
KE-0075	Laikipia Air Base	KE
KEAR	Kearney Regional Airport	US
KEAT	Pangborn Memorial Airport	US
KEAU	Chippewa Valley Regional Airport	US
KECG	Elizabeth City Regional Airport & Coast Guard Air Station	US
KECP	Northwest Florida Beaches International Airport	US
KEDW	Edwards Air Force Base	US
KEED	Needles Airport	US
KEEN	Dillant Hopkins Airport	US
KEET	Shelby County Airport	US
KEFD	Ellington Airport	US
KEGE	Eagle County Regional Airport	US
KEGI	Duke Field	US
KEKA	Murray Field	US
KEKN	Elkins-Randolph County Regional Airport	US
KEKO	Elko Regional Airport	US
KELD	South Arkansas Regional Airport at Goodwin Field	US
KELM	Elmira Corning Regional Airport	US
KELO	Ely Municipal Airport	US
KELP	El Paso International Airport	US
KELY	Ely Airport Yelland Field	US
KEND	Vance Air Force Base	US
KENV	Wendover Airport	US
KENW	Kenosha Regional Airport	US
KERI	Erie International Tom Ridge Field	US
KESF	Esler Army Airfield / Esler Regional Airport	US
KEUG	Mahlon Sweet Field	US
KEVV	Evansville Regional Airport	US
KEVW	Evanston-Uinta County Airport-Burns Field	US
KEWB	New Bedford Regional Airport	US
KEWN	Coastal Carolina Regional Airport	US
KEWR	Newark Liberty International Airport	US
KEYW	Key West International Airport	US
KFAF	Felker Army Air Field	US
KFAR	Hector International Airport	US
KFAT	Fresno Yosemite International Airport	US
KFAY	Fayetteville Regional Airport - Grannis Field	US
KFBG	Simmons Army Air Field	US
KFCS	Butts AAF (Fort Carson) Air Field	US
KFDY	Findlay Airport	US
KFFO	Wright-Patterson Air Force Base	US
KFHU	Sierra Vista Municipal Airport / Libby Army Air Field	US
KFKL	Venango Regional Airport	US
KFLG	Flagstaff Pulliam International Airport	US
KFLL	Fort Lauderdale Hollywood International Airport	US
KFLO	Florence Regional Airport	US
KFME	Tipton Airport	US
KFMN	Four Corners Regional Airport	US
KFMY	Page Field	US
KFNT	Bishop International Airport	US
KFOD	Fort Dodge Regional Airport	US
KFOE	Topeka Regional Airport	US
KFPR	St Lucie County International Airport	US
KFRG	Republic Airport	US
KFRI	Marshall Army Air Field	US
KFSD	Sioux Falls Regional Airport / Joe Foss Field	US
KFSI	Henry Post Army Air Field (Fort Sill)	US
KFSM	Fort Smith Regional Airport	US
KFST	Fort Stockton Pecos County Airport	US
KFTK	Godman Army Air Field	US
KFTW	Fort Worth Meacham International Airport	US
KFTY	Fulton County Airport Brown Field	US
KFWA	Fort Wayne International Airport	US
KFXE	Fort Lauderdale Executive Airport	US
KFYV	Drake Field	US
KG-0001	Jalal-Abad Airport	KG
KGCC	Northeast Wyoming Regional Airport	US
KGCK	Garden City Regional Airport	US
KGCN	Grand Canyon National Park Airport	US
KGDV	Dawson Community Airport	US
KGEG	Spokane International Airport	US
KGFK	Grand Forks International Airport	US
KGFL	Floyd Bennett Memorial Airport	US
KGGG	East Texas Regional Airport	US
KGGW	Wokal Field/Glasgow-Valley County Airport	US
KGJT	Grand Junction Regional Airport	US
KGLD	Goodland Municipal Airport	US
KGLH	Mid Delta Regional Airport	US
KGLS	Scholes International At Galveston Airport	US
KGMU	Greenville Downtown Airport	US
KGNV	Gainesville Regional Airport	US
KGON	Groton New London Airport	US
KGPI	Glacier Park International Airport	US
KGPT	Gulfport Biloxi International Airport	US
KGRB	Austin Straubel International Airport	US
KGRF	Gray Army Air Field	US
KGRI	Central Nebraska Regional Airport	US
KGRK	Killeen-Fort Hood Regional Airport / Robert Gray Army Air Field	US
KGRR	Gerald R. Ford International Airport	US
KGSB	Seymour Johnson Air Force Base	US
KGSO	Piedmont Triad International Airport	US
KGSP	Greenville Spartanburg International Airport	US
KGTB	Wheeler Sack Army Air Field	US
KGTF	Great Falls International Airport	US
KGTR	Golden Triangle Regional Airport	US
KGUP	Gallup Municipal Airport	US
KGUS	Grissom Air Reserve Base	US
KGUY	Guymon Municipal Airport	US
KGWO	Greenwood–Leflore Airport	US
KGYY	Gary Chicago International Airport	US
KHBG	Hattiesburg Bobby L Chain Municipal Airport	US
KHBR	Hobart Regional Airport	US
KHFD	Hartford Brainard Airport	US
KHGR	Hagerstown Regional Richard A Henson Field	US
KHHR	Jack Northrop Field Hawthorne Municipal Airport	US
KHIB	Range Regional Airport	US
KHIF	Hill Air Force Base	US
KHII	Lake Havasu City International Airport	US
KHIO	Portland Hillsboro Airport	US
KHKY	Hickory Regional Airport	US
KHLG	Wheeling Ohio County Airport	US
KHLN	Helena Regional Airport	US
KHLR	Hood Army Air Field	US
KHMN	Holloman Air Force Base	US
KHOB	Lea County Regional Airport	US
KHON	Huron Regional Airport	US
KHOP	Campbell Army Airfield (Fort Campbell)	US
KHOT	Memorial Field Airport	US
KHOU	William P Hobby Airport	US
KHPN	Westchester County Airport	US
KHQM	Bowerman Airport	US
KHRL	Valley International Airport	US
KHRO	Boone County Airport	US
KHRT	Hurlburt Field	US
KHST	Homestead ARB Airport	US
KHSV	Huntsville International Carl T Jones Field	US
KHTS	Tri-State Airport / Milton J. Ferguson Field	US
KHUA	Redstone Army Air Field	US
KHUF	Terre Haute Regional Airport, Hulman Field	US
KHUL	Houlton International Airport	US
KHUT	Hutchinson Municipal Airport	US
KHVN	Tweed New Haven Airport	US
KHVR	Havre City County Airport	US
KHYA	Cape Cod Gateway Airport	US
KHYI	San Marcos Regional Airport	US
KHYR	Sawyer County Airport	US
KHYS	Hays Regional Airport	US
KHZY	Northeast Ohio Regional Airport	US
KI39	Central Kentucky Regional Airport	US
KIAB	McConnell Air Force Base	US
KIAD	Washington Dulles International Airport	US
KIAG	Niagara Falls International Airport	US
KIAH	George Bush Intercontinental Houston Airport	US
KICT	Wichita Eisenhower National Airport	US
KIDA	Idaho Falls Regional Airport	US
KIFP	Laughlin Bullhead International Airport	US
KIGM	Kingman Airport	US
KIKK	Greater Kankakee Airport	US
KILG	New Castle Airport	US
KILM	Wilmington International Airport	US
KILN	Wilmington Airpark	US
KIND	Indianapolis International Airport	US
KINK	Winkler County Airport	US
KINL	Falls International Airport	US
KINT	Smith Reynolds Airport	US
KINW	Winslow Lindbergh Regional Airport	US
KIPL	Imperial County Airport	US
KIPT	Williamsport Regional Airport	US
KIRK	Kirksville Regional Airport	US
KISM	Kissimmee Gateway Airport	US
KISO	Kinston Regional Jetport At Stallings Field	US
KISP	Long Island Mac Arthur Airport	US
KITH	Ithaca Tompkins Regional Airport	US
KIWA	Phoenix–Mesa Gateway Airport	US
KJAC	Jackson Hole Airport	US
KJAN	Jackson-Medgar Wiley Evers International Airport	US
KJAX	Jacksonville International Airport	US
KJBR	Jonesboro Municipal Airport	US
KJCT	Kimble County Airport	US
KJFK	John F Kennedy International Airport	US
KJHW	Chautauqua County-Jamestown Airport	US
KJKL	Julian Carroll Airport	US
KJLN	Joplin Regional Airport	US
KJMS	Jamestown Regional Airport	US
KJQF	Concord-Padgett Regional Airport	US
KJST	John Murtha Johnstown Cambria County Airport	US
KJXN	Jackson County Airport/Reynolds Field	US
KKLS	Southwest Washington Regional Airport	US
KL45	Bakersfield International Airport	US
KLAA	Southeast Colorado Regional Airport	US
KLAF	Purdue University Airport	US
KLAL	Lakeland Linder International Airport	US
KLAN	Capital City Airport	US
KLAR	Laramie Regional Airport	US
KLAS	Harry Reid International Airport	US
KLAW	Lawton Fort Sill Regional Airport	US
KLAX	Los Angeles International Airport	US
KLBB	Lubbock Preston Smith International Airport	US
KLBE	Arnold Palmer Regional Airport	US
KLBF	North Platte Regional Airport Lee Bird Field	US
KLBL	Liberal Mid-America Regional Airport	US
KLBT	Lumberton Regional Airport	US
KLBX	Texas Gulf Coast Regional Airport	US
KLCH	Lake Charles Regional Airport	US
KLCK	Rickenbacker International Airport	US
KLEB	Lebanon Municipal Airport	US
KLEE	Leesburg International Airport	US
KLEX	Blue Grass Airport	US
KLFI	Langley Air Force Base	US
KLFK	Angelina County Airport	US
KLFT	Lafayette Regional Airport	US
KLGA	La Guardia Airport	US
KLGB	Long Beach Airport (Daugherty Field)	US
KLGU	Logan-Cache Airport	US
KLIT	Bill & Hillary Clinton National Airport/Adams Field	US
KLLQ	Monticello Municipal Ellis Field	US
KLMT	Crater Lake-Klamath Regional Airport	US
KLND	Hunt Field	US
KLNK	Lincoln Airport	US
KLNS	Lancaster Airport	US
KLOL	Derby Field	US
KLOU	Bowman Field	US
KLOZ	London-Corbin Airport/Magee Field	US
KLRD	Laredo International Airport	US
KLRF	Little Rock Air Force Base	US
KLRU	Las Cruces International Airport	US
KLSE	La Crosse Regional Airport	US
KLSF	Lawson Army Air Field	US
KLSV	Nellis Air Force Base	US
KLTS	Altus Air Force Base	US
KLUF	Luke Air Force Base	US
KLUK	Cincinnati Municipal Airport Lunken Field	US
KLVM	Mission Field	US
KLVS	Las Vegas Municipal Airport	US
KLWB	Greenbrier Valley Airport	US
KLWM	Lawrence Municipal Airport	US
KLWS	Lewiston Nez Perce County Airport	US
KLWT	Lewistown Municipal Airport	US
KLYH	Lynchburg Regional Airport - Preston Glenn Field	US
KMAF	Midland International Air and Space Port	US
KMBG	Mobridge Municipal Airport	US
KMBS	MBS International Airport	US
KMCB	McComb-Pike County Airport / John E Lewis Field	US
KMCC	McClellan Airfield	US
KMCE	Merced Regional Macready Field	US
KMCF	MacDill Air Force Base	US
KMCI	Kansas City International Airport	US
KMCK	Mc Cook Ben Nelson Regional Airport	US
KMCN	Middle Georgia Regional Airport	US
KMCO	Orlando International Airport	US
KMCW	Mason City Municipal Airport	US
KMDH	Southern Illinois Airport	US
KMDT	Harrisburg International Airport	US
KMDW	Chicago Midway International Airport	US
KMEI	Key Field / Meridian Regional Airport	US
KMEM	Memphis International Airport	US
KMER	Castle Airport	US
KMFD	Mansfield Lahm Regional Airport	US
KMFE	McAllen Miller International Airport	US
KMFR	Rogue Valley International Medford Airport	US
KMGE	Dobbins Air Reserve Base	US
KMGM	Montgomery Regional (Dannelly Field) Airport	US
KMGW	Morgantown Municipal Airport Walter L. (Bill) Hart Field	US
KMHK	Manhattan Regional Airport	US
KMHR	Sacramento Mather Airport	US
KMHT	Manchester-Boston Regional Airport	US
KMIA	Miami International Airport	US
KMIB	Minot Air Force Base	US
KMIE	Delaware County Johnson Field	US
KMIV	Millville Municipal Airport	US
KMKC	Charles B. Wheeler Downtown Airport	US
KMKE	General Mitchell International Airport	US
KMKG	Muskegon County Airport	US
KMKL	McKellar-Sipes Regional Airport	US
KMLB	Melbourne Orlando International Airport	US
KMLC	Mc Alester Regional Airport	US
KMLI	Quad City International Airport	US
KMLS	Miles City Airport - Frank Wiley Field	US
KMLU	Monroe Regional Airport	US
KMMT	Mc Entire Joint National Guard Base	US
KMMU	Morristown Municipal Airport	US
KMMV	Mc Minnville Municipal Airport	US
KMOB	Mobile Regional Airport	US
KMOD	Modesto City Co-Harry Sham Field	US
KMOT	Minot International Airport	US
KMPV	Edward F Knapp State Airport	US
KMQY	Smyrna Airport	US
KMRB	Eastern WV Regional Airport/Shepherd Field	US
KMRY	Monterey Peninsula Airport	US
KMSL	Northwest Alabama Regional Airport	US
KMSN	Dane County Regional Truax Field	US
KMSO	Missoula International Airport	US
KMSP	Minneapolis–Saint Paul International Airport / Wold–Chamberlain Field	US
KMSS	Massena International Airport Richards Field	US
KMSY	Louis Armstrong New Orleans International Airport	US
KMTC	Selfridge Air National Guard Base Airport	US
KMTH	The Florida Keys Marathon Airport	US
KMTJ	Montrose Regional Airport	US
KMTN	Martin State Airport	US
KMUI	Muir Army Air Field (Fort Indiantown Gap) Airport	US
KMUO	Mountain Home Air Force Base	US
KMWH	Grant County International Airport	US
KMXF	Maxwell Air Force Base	US
KMYL	McCall Municipal Airport	US
KMYR	Myrtle Beach International Airport	US
KMYV	Yuba County Airport	US
KNBC	Beaufort MCAS - Merritt Field	US
KNBG	New Orleans NAS JRB/Alvin Callender Field	US
KNCA	MCAS New River / McCutcheon Field	US
KNDZ	Whiting Field Naval Air Station South Airport	US
KNEL	Lakehurst Maxfield Field Airport	US
KNEW	Lakefront Airport	US
KNFG	Camp Pendleton MCAS (Munn Field) Airport	US
KNFL	Fallon Naval Air Station	US
KNFW	NAS Fort Worth JRB / Carswell Field	US
KNGP	Corpus Christi Naval Air Station/Truax Field	US
KNGU	Norfolk Naval Station (Chambers Field)	US
KNHK	Patuxent River Naval Air Station (Trapnell Field)	US
KNHZ	Brunswick Executive Airport	US
KNID	China Lake Naws (Armitage Field) Airport	US
KNIP	Jacksonville Naval Air Station (Towers Field)	US
KNJK	El Centro NAF Airport (Vraciu Field)	US
KNKT	Cherry Point MCAS /Cunningham Field/	US
KNKX	Miramar Marine Corps Air Station - Mitscher Field	US
KNLC	Lemoore Naval Air Station (Reeves Field) Airport	US
KNMM	Naval Air Station Meridian / McCain Field	US
KNPA	Naval Air Station Pensacola Forrest Sherman Field	US
KNQA	Millington-Memphis Airport	US
KNQI	Kingsville Naval Air Station	US
KNQX	Naval Air Station Key West/Boca Chica Field	US
KNRB	Naval Station Mayport / Admiral David L McDonald Field	US
KNSE	Whiting Field Naval Air Station - North	US
KNTD	Point Mugu Naval Air Station (Naval Base Ventura Co)	US
KNTU	Oceana Naval Air Station	US
KNUQ	Moffett Federal Airfield	US
KNUW	Whidbey Island Naval Air Station (Ault Field)	US
KNXP	Twentynine Palms Strategic Expeditionary Landing Field	US
KNYG	Quantico Marine Corps Airfield / Turner Field	US
KNYL	Yuma International Airport / Marine Corps Air Station Yuma	US
KNZY	North Island Naval Air Station-Halsey Field	US
KOAJ	Albert J Ellis Airport	US
KOAK	Metropolitan Oakland International Airport	US
KOFK	Karl Stefan Memorial Airport	US
KOGB	Orangeburg Municipal Airport	US
KOGD	Ogden Hinckley Airport	US
KOKC	Will Rogers World Airport	US
KOLF	L M Clayton Airport	US
KOLM	Olympia Regional Airport	US
KOLS	Nogales International Airport	US
KOLU	Columbus Municipal Airport	US
KOMA	Eppley Airfield	US
KONO	Ontario Municipal Airport	US
KONP	Newport Municipal Airport	US
KONT	Ontario International Airport	US
KOPF	Miami-Opa Locka Executive Airport	US
KOQU	Quonset State Airport	US
KORD	Chicago O'Hare International Airport	US
KORF	Norfolk International Airport	US
KORH	Worcester Regional Airport	US
KOSH	Wittman Regional Airport	US
KOSU	The Ohio State University Airport - Don Scott Field	US
KOTH	Southwest Oregon Regional Airport	US
KOTM	Ottumwa Regional Airport	US
KOWB	Owensboro Daviess County Airport	US
KOWD	Norwood Memorial Airport	US
KOXR	Oxnard Airport	US
KOZR	Cairns AAF (Fort Rucker) Air Field	US
KP-0002	Haeju Airfield	KP
KP-0012	Kwaksan Air Base	KP
KP-0015	Koksan Air Base	KP
KP-0020	Hwangju Airbase	KP
KP-0022	Pukchang Air Base	KP
KP-0025	Toksan Air Base	KP
KP-0032	Orang (Chongjin) Airport	KP
KP-0035	Hwangsuwon Airbase	KP
KP-0036	Changjin Air Force Base	KP
KP-0038	Riwon Airbase	KP
KP-0039	Kwail Air Base	KP
KP-0041	Uthachi Highway Strip Airport	KP
KP-0068	Koksan 2 Highway Strip	KP
KPAE	Snohomish County (Paine Field) Airport	US
KPAH	Barkley Regional Airport	US
KPAM	Tyndall Air Force Base	US
KPBF	Pine Bluff Regional Airport, Grider Field	US
KPBG	Plattsburgh International Airport	US
KPBI	Palm Beach International Airport	US
KPDK	DeKalb Peachtree Airport	US
KPDT	Eastern Oregon Regional Airport at Pendleton	US
KPDX	Portland International Airport	US
KPGA	Page Municipal Airport	US
KPGD	Charlotte County Airport	US
KPGV	Pitt Greenville Airport	US
KPHF	Newport News Williamsburg International Airport	US
KPHL	Philadelphia International Airport	US
KPHX	Phoenix Sky Harbor International Airport	US
KPIA	General Wayne A. Downing Peoria International Airport	US
KPIB	Hattiesburg Laurel Regional Airport	US
KPIE	St. Petersburg Clearwater International Airport	US
KPIH	Pocatello Regional Airport	US
KPIR	Pierre Regional Airport	US
KPIT	Pittsburgh International Airport	US
KPKB	Mid Ohio Valley Regional Airport	US
KPLN	Pellston Regional Airport of Emmet County Airport	US
KPMD	Palmdale Regional Airport / USAF Plant 42 Airport	US
KPNA	Ralph Wenz Field	US
KPNC	Ponca City Regional Airport	US
KPNE	Northeast Philadelphia Airport	US
KPNS	Pensacola International Airport	US
KPOB	Pope Field	US
KPOE	Polk Army Air Field	US
KPOU	Dutchess County Airport	US
KPQI	Presque Isle International Airport	US
KPRB	Paso Robles Municipal Airport	US
KPRC	Prescott International Airport - Ernest A. Love Field	US
KPRX	Cox Field	US
KPSC	Tri Cities Airport	US
KPSM	Portsmouth International at Pease Airport	US
KPSP	Palm Springs International Airport	US
KPTK	Oakland County International Airport	US
KPUB	Pueblo Memorial Airport	US
KPUW	Pullman Moscow Regional Airport	US
KPVD	Theodore Francis Green State Airport	US
KPVU	Provo-Utah Lake International Airport	US
KPWK	Chicago Executive Airport	US
KPWM	Portland International Jetport	US
KPWT	Bremerton National Airport	US
KRAL	Riverside Municipal Airport	US
KRAP	Rapid City Regional Airport	US
KRBL	Red Bluff Municipal Airport	US
KRCA	Ellsworth Air Force Base	US
KRDD	Redding Municipal Airport	US
KRDG	Reading Regional Airport (Carl A Spaatz Field)	US
KRDM	Roberts Field	US
KRDR	Grand Forks Air Force Base	US
KRDU	Raleigh Durham International Airport	US
KRFD	Chicago Rockford International Airport	US
KRHI	Rhinelander Oneida County Airport	US
KRIC	Richmond International Airport	US
KRIL	Garfield County Regional Airport	US
KRIV	March Air Reserve Base	US
KRIW	Central Wyoming Regional Airport	US
KRKS	Southwest Wyoming Regional Airport	US
KRME	Griffiss International Airport	US
KRMG	Richard B Russell Airport	US
KRND	Randolph Air Force Base	US
KRNH	New Richmond Regional Airport	US
KRNO	Reno Tahoe International Airport	US
KROA	Roanoke–Blacksburg Regional Airport	US
KROC	Frederick Douglass Greater Rochester International Airport	US
KROW	Roswell Air Center Airport	US
KRSL	Russell Municipal Airport	US
KRST	Rochester International Airport	US
KRSW	Southwest Florida International Airport	US
KRUT	Rutland - Southern Vermont Regional Airport	US
KRVS	Richard Lloyd Jones Jr Airport	US
KRWF	Redwood Falls Municipal Airport	US
KRWI	Rocky Mount Wilson Regional Airport	US
KRWL	Rawlins Municipal Airport/Harvey Field	US
KRYY	Cobb County International Airport-McCollum Field	US
KSAC	Sacramento Executive Airport	US
KSAF	Santa Fe Municipal Airport	US
KSAN	San Diego International Airport	US
KSAT	San Antonio International Airport	US
KSAV	Savannah Hilton Head International Airport	US
KSAW	Sawyer International Airport	US
KSBA	Santa Barbara Municipal Airport	US
KSBD	San Bernardino International Airport	US
KSBN	South Bend Regional Airport	US
KSBP	San Luis County Regional Airport	US
KSBY	Salisbury Ocean City Wicomico Regional Airport	US
KSCH	Schenectady County Airport	US
KSCK	Stockton Metropolitan Airport	US
KSDF	Louisville Muhammad Ali International Airport	US
KSDM	Brown Field Municipal Airport	US
KSDY	Sidney - Richland Regional Airport	US
KSEA	Seattle–Tacoma International Airport	US
KSFB	Orlando Sanford International Airport	US
KSFF	Felts Field	US
KSFO	San Francisco International Airport	US
KSGF	Springfield Branson National Airport	US
KSGH	Springfield-Beckley Municipal Airport	US
KSGJ	Northeast Florida Regional Airport	US
KSGR	Sugar Land Regional Airport	US
KSGU	St George Regional Airport	US
KSHD	Shenandoah Valley Regional Airport	US
KSHR	Sheridan County Airport	US
KSHV	Shreveport Regional Airport	US
KSJC	Norman Y. Mineta San Jose International Airport	US
KSJT	San Angelo Regional Mathis Field	US
KSKA	Fairchild Air Force Base	US
KSKF	Lackland Air Force Base	US
KSLC	Salt Lake City International Airport	US
KSLE	Salem Municipal Airport/McNary Field	US
KSLI	Los Alamitos Army Air Field	US
KSLK	Adirondack Regional Airport	US
KSLN	Salina Municipal Airport	US
KSME	Lake Cumberland Regional Airport	US
KSMF	Sacramento International Airport	US
KSMN	Lemhi County Airport	US
KSMO	Santa Monica Municipal Airport	US
KSMX	Santa Maria Public Airport Captain G Allan Hancock Field	US
KSNA	John Wayne Airport-Orange County Airport	US
KSNS	Salinas Municipal Airport	US
KSNY	Sidney Municipal-Lloyd W Carr Field	US
KSOA	Sonora Municipal Airport	US
KSPI	Abraham Lincoln Capital Airport	US
KSPS	Sheppard Air Force Base / Wichita Falls Municipal Airport	US
KSRQ	Sarasota Bradenton International Airport	US
KSRR	Sierra Blanca Regional Airport	US
KSSC	Shaw Air Force Base	US
KSSF	Stinson Municipal Airport	US
KSSI	St Simons Island Airport	US
KSTC	Saint Cloud Regional Airport	US
KSTJ	Rosecrans Memorial Airport	US
KSTL	St Louis Lambert International Airport	US
KSTP	St Paul Downtown Holman Field	US
KSTS	Charles M. Schulz Sonoma County Airport	US
KSUN	Friedman Memorial Airport	US
KSUS	Spirit of St Louis Airport	US
KSUU	Travis Air Force Base	US
KSUX	Sioux Gateway Airport / Brigadier General Bud Day Field	US
KSUZ	Saline County Regional Airport	US
KSVN	Hunter Army Air Field	US
KSWF	New York Stewart International Airport	US
KSWO	Stillwater Regional Airport	US
KSYR	Syracuse Hancock International Airport	US
KSZL	Whiteman Air Force Base	US
KTBN	Waynesville-St. Robert Regional Airport-Forney Field	US
KTCC	Tucumcari Municipal Airport	US
KTCL	Tuscaloosa Regional Airport	US
KTCM	McChord Air Force Base	US
KTCS	Truth or Consequences Municipal Airport	US
KTEB	Teterboro Airport	US
KTIK	Tinker Air Force Base	US
KTIW	Tacoma Narrows Airport	US
KTIX	Space Coast Regional Airport	US
KTLH	Tallahassee Regional Airport	US
KTMB	Miami Executive Airport	US
KTOI	Troy Municipal Airport at N Kenneth Campbell Field	US
KTOL	Eugene F. Kranz Toledo Express Airport	US
KTOP	Philip Billard Municipal Airport	US
KTPA	Tampa International Airport	US
KTPH	Tonopah Airport	US
KTPL	Draughon Miller Central Texas Regional Airport	US
KTRI	Tri-Cities Regional TN/VA Airport	US
KTRK	Truckee Tahoe Airport	US
KTRM	Jacqueline Cochran Regional Airport	US
KTTD	Portland Troutdale Airport	US
KTTN	Trenton Mercer Airport	US
KTTS	NASA Shuttle Landing Facility Airport	US
KTUL	Tulsa International Airport	US
KTUP	Tupelo Regional Airport	US
KTUS	Tucson International Airport / Morris Air National Guard Base	US
KTVC	Cherry Capital Airport	US
KTVL	Lake Tahoe Airport	US
KTWF	Joslin Field Magic Valley Regional Airport	US
KTXK	Texarkana Regional Airport (Webb Field)	US
KTYR	Tyler Pounds Regional Airport	US
KTYS	McGhee Tyson Airport	US
KU42	South Valley Regional Airport	US
KUAO	Aurora State Airport	US
KUIN	Quincy Regional Baldwin Field	US
KUKI	Ukiah Municipal Airport	US
KUNV	University Park Airport	US
KUOX	University Oxford Airport	US
KUTS	Huntsville Regional Airport	US
KVAD	Moody Air Force Base	US
KVBG	Vandenberg Space Force Base	US
KVCT	Victoria Regional Airport	US
KVEL	Vernal Regional Airport	US
KVGT	North Las Vegas Metropolitan International Airport	US
KVIS	Visalia Municipal Airport	US
KVLD	Valdosta Regional Airport	US
KVNY	Van Nuys Airport	US
KVOK	Volk Field	US
KVPS	Destin-Fort Walton Beach Airport	US
KVPZ	Porter County Municipal Airport	US
KVRB	Vero Beach Regional Airport	US
KVTN	Miller Field	US
KW63	Lake Country Regional Airport	US
KWJF	General William J Fox Airfield	US
KWMC	Winnemucca Municipal Airport	US
KWRB	Robins Air Force Base	US
KWRI	Mc Guire Air Force Base	US
KWRL	Worland Municipal Airport	US
KWWD	Cape May County Airport	US
KWWR	West Woodward Airport	US
KWY	Kiwayu Airport	KE
KWYS	Yellowstone Airport	US
KXMR	Cape Canaveral SFS Skid Strip	US
KXNA	Northwest Arkansas Regional Airport	US
KXTA	Homey (Area 51) Airport	US
KYIP	Willow Run Airport	US
KYKM	Yakima Air Terminal McAllister Field	US
KYKN	Chan Gurney Municipal Airport	US
KYNG	Youngstown Warren Regional Airport	US
KZ-0067	Krainiy Airport	KZ
KZ-0068	Kurchatov Airfield	KZ
KZ-0069	Zhangiztobe Air Base	KZ
KZ-7470	Dolon Air Base	KZ
KZZV	Zanesville Municipal Airport	US
LA-0006	Bokeo International Airport	LA
LAKU	Kukës International Airport	AL
LAKV	Kuçovë Air Base	AL
LATI	Tirana International Airport Mother Teresa	AL
LBBG	Burgas Airport	BG
LBGO	Gorna Oryahovitsa Airport	BG
LBPD	Plovdiv International Airport	BG
LBPG	Graf Ignatievo Air Base	BG
LBPL	Dolna Mitropoliya Air Base	BG
LBSF	Sofia Airport	BG
LBWB	Balchik Airfield	BG
LBWN	Varna Airport	BG
LCEN	Nicosia (Lefkoşa) Ercan International Airport	CY
LCLK	Larnaca International Airport	CY
LCPH	Paphos International Airport	CY
LCRA	RAF Akrotiri	CY
LDDU	Dubrovnik Airport	HR
LDOS	Osijek Airport	HR
LDPL	Pula Airport	HR
LDRI	Rijeka Airport	HR
LDSB	Brač Airport	HR
LDSP	Split Airport	HR
LDZA	Zagreb Airport	HR
LDZD	Zadar Airport	HR
LEAB	Albacete Airport / Los Llanos Air Base	ES
LEAL	Alicante-Elche Miguel Hernández Airport	ES
LEAM	Almería Airport	ES
LEAS	Asturias Airport	ES
LEBA	Córdoba Airport	ES
LEBB	Bilbao Airport	ES
LEBG	Burgos Airport	ES
LEBL	Josep Tarradellas Barcelona-El Prat Airport	ES
LEBZ	Badajoz Airport	ES
LECH	Castellón-Costa Azahar Airport	ES
LECO	A Coruña Airport	ES
LECU	Madrid-Cuatro Vientos Airport	ES
LEDA	Lleida-Alguaire Airport	ES
LEGA	Armilla Air Base	ES
LEGE	Girona-Costa Brava Airport	ES
LEGR	F.G.L. Airport Granada-Jaén Airport	ES
LEGT	Getafe Air Base	ES
LEIB	Ibiza Airport	ES
LEJR	Jerez Airport	ES
LELC	San Javier Airport	ES
LELN	León Airport	ES
LELO	Logroño-Agoncillo Airport	ES
LEMD	Adolfo Suárez Madrid–Barajas Airport	ES
LEMG	Málaga-Costa del Sol Airport	ES
LEMH	Menorca Airport	ES
LEMI	Región de Murcia International Airport	ES
LEMO	Moron Air Base	ES
LEPA	Palma de Mallorca Airport	ES
LEPP	Pamplona Airport	ES
LERI	Alcantarilla Air Base	ES
LERL	Ciudad Real International Airport	ES
LERS	Reus Airport	ES
LERT	Rota Naval Station Airport	ES
LESA	Salamanca Airport	ES
LESO	San Sebastián Airport	ES
LEST	Santiago-Rosalía de Castro Airport	ES
LETL	Teruel Airport	ES
LETO	Madrid–Torrejón Airport / Torrejón Air Base	ES
LEVC	Valencia Airport	ES
LEVD	Valladolid Airport	ES
LEVT	Vitoria Airport	ES
LEVX	Vigo Airport	ES
LEXJ	Seve Ballesteros-Santander Airport	ES
LEZG	Zaragoza Airport	ES
LEZL	Sevilla Airport	ES
LFAC	Calais-Dunkerque Airport	FR
LFAG	Aérodrome de Péronne Saint-Quentin	FR
LFAT	Le Touquet-Côte d'Opale Airport	FR
LFAV	Valenciennes-Denain Airfield	FR
LFAY	Aérodrome d'Amiens-Glisy	FR
LFBA	Agen-La Garenne Airport	FR
LFBC	Cazaux (BA 120) Air Base	FR
LFBD	Bordeaux-Mérignac Airport	FR
LFBE	Bergerac-Roumanière Airport	FR
LFBF	Toulouse-Francazal (BA 101) Air Base	FR
LFBG	Cognac-Châteaubernard (BA 709) Air Base	FR
LFBH	La Rochelle-Île de Ré Airport	FR
LFBI	Poitiers-Biard Airport	FR
LFBK	Montluçon-Guéret Airport	FR
LFBL	Limoges Airport	FR
LFBM	Mont-de-Marsan (BA 118) Air Base	FR
LFBN	Niort-Souché Airport	FR
LFBO	Toulouse-Blagnac Airport	FR
LFBP	Pau Pyrénées Airport	FR
LFBT	Tarbes-Lourdes-Pyrénées Airport	FR
LFBU	Angoulême-Brie-Champniers Airport	FR
LFBX	Périgueux-Bassillac Airport	FR
LFBZ	Biarritz-Anglet-Bayonne Airport	FR
LFCC	Aérodrome de Cahors-Lalbenque	FR
LFCG	Aérodrome de Saint-Girons - Antichan	FR
LFCH	Aérodrome d'Arcachon-La Teste-de-Buch	FR
LFCI	Albi-Le Séquestre Airport	FR
LFCK	Castres-Mazamet Airport	FR
LFCR	Rodez-Marcillac Airport	FR
LFCY	Royan-Médis Airport	FR
LFDH	Auch-Lamothe Airport	FR
LFDI	Libourne-Artigues-de-Lussac Airport	FR
LFDN	Rochefort-Saint-Agnant (BA 721) Airport	FR
LFEY	Île d'Yeu Airport	FR
LFGA	Colmar-Houssen Airport	FR
LFGJ	Dole-Tavaux Airport	FR
LFGW	Verdun-Le Rozelier Airfield	FR
LFHO	Aubenas-Ardèche Méridional Airport	FR
LFHP	Le Puy-Loudes Airfield	FR
LFJL	Metz-Nancy-Lorraine Airport	FR
LFJR	Angers-Loire Airport	FR
LFKB	Bastia-Poretta Airport	FR
LFKC	Calvi-Sainte-Catherine Airport	FR
LFKF	Figari Sud-Corse Airport	FR
LFKJ	Ajaccio-Napoléon Bonaparte Airport	FR
LFKS	Solenzara (BA 126) Air Base	FR
LFLA	Auxerre-Branches Airport	FR
LFLB	Chambéry-Savoie Airport	FR
LFLC	Clermont-Ferrand Auvergne Airport	FR
LFLD	Bourges Airport	FR
LFLH	Chalon-Champforgeuil Airfield	FR
LFLI	Annemasse Airfield	FR
LFLL	Lyon Saint-Exupéry Airport	FR
LFLM	Aérodrome de Mâcon-Charnay	FR
LFLN	Saint-Yan Airport	FR
LFLO	Roanne-Renaison Airport	FR
LFLP	Annecy-Haute-Savoie-Mont Blanc Airport	FR
LFLS	Grenoble-Isère Airport	FR
LFLU	Valence-Chabeuil Airport	FR
LFLV	Vichy-Charmeil Airport	FR
LFLW	Aurillac Airport	FR
LFLX	Châteauroux-Déols "Marcel Dassault" Airport	FR
LFLY	Lyon-Bron Airport	FR
LFMC	Le Luc-Le Cannet Airport	FR
LFMD	Cannes-Mandelieu Airport	FR
LFMH	Saint-Étienne-Bouthéon Airport	FR
LFMI	Istres Le Tubé Air Base	FR
LFMK	Carcassonne Airport	FR
LFML	Marseille Provence Airport	FR
LFMN	Nice-Côte d'Azur Airport	FR
LFMO	Orange-Caritat (BA 115) Air Base	FR
LFMP	Perpignan-Rivesaltes (Llabanère) Airport	FR
LFMQ	Le Castellet Airport	FR
LFMS	Aérodrome d'Alès Cévennes	FR
LFMT	Montpellier-Méditerranée Airport	FR
LFMU	Béziers-Vias Airport	FR
LFMV	Avignon-Caumont Airport	FR
LFMY	Salon-de-Provence (BA 701) Air Base	FR
LFNB	Mende-Brenoux Airfield	FR
LFOA	Avord (BA 702) Air Base	FR
LFOB	Paris Beauvais Tillé Airport	FR
LFOC	Châteaudun (BA 279) Air Base	FR
LFOE	Évreux-Fauville (BA 105) Air Base	FR
LFOH	Le Havre-Octeville Airport	FR
LFOI	Abbeville	FR
LFOJ	Orléans-Bricy (BA 123) Air Base	FR
LFOK	Châlons-Vatry Airport	FR
LFOP	Rouen Vallée de Seine Airport	FR
LFOT	Tours-Val-de-Loire Airport	FR
LFOU	Cholet Le Pontreau Airport	FR
LFOV	Laval-Entrammes Airport	FR
LFPB	Paris-Le Bourget Airport	FR
LFPC	Creil Air Base	FR
LFPG	Charles de Gaulle International Airport	FR
LFPM	Melun-Villaroche Air Base	FR
LFPN	Toussus-le-Noble Airport	FR
LFPO	Paris-Orly Airport	FR
LFPT	Aérodrome de Pontoise - Cormeilles en Vexin	FR
LFPV	Vélizy-Villacoublay Air Base	FR
LFQB	Troyes-Barberey Airport	FR
LFQE	Lieutenant Étienne Mantoux Air Base	FR
LFQG	Nevers-Fourchambault Airport	FR
LFQJ	Maubeuge-Élesmes Airfield	FR
LFQP	Phalsbourg-Bourscheid Air Base	FR
LFQQ	Lille-Lesquin Airport	FR
LFQT	Merville-Calonne Airport	FR
LFQV	Charleville-Mézières Ardennes-Etienne Riché Airfield	FR
LFQW	Aérodrome de Vesoul-Frotey	FR
LFRB	Brest Bretagne Airport	FR
LFRC	Cherbourg-Maupertus Airport	FR
LFRD	Dinard-Pleurtuit-Saint-Malo Airport	FR
LFRE	La Baule-Escoublac Airport	FR
LFRF	Granville Airport	FR
LFRG	Deauville-Saint-Gatien Airport	FR
LFRH	Lorient South Brittany (Bretagne Sud) Airport	FR
LFRI	La Roche-sur-Yon Airport	FR
LFRJ	Landivisiau Air Base	FR
LFRK	Caen-Carpiquet Airport	FR
LFRL	Lanvéoc-Poulmic Air Base	FR
LFRM	Le Mans-Arnage Airport	FR
LFRN	Rennes-Saint-Jacques Airport	FR
LFRO	Lannion-Côte de Granit Airport	FR
LFRQ	Quimper-Cornouaille Airport	FR
LFRS	Nantes Atlantique Airport	FR
LFRT	Saint-Brieuc-Armor Airport	FR
LFRU	Morlaix-Ploujean Airport	FR
LFRV	Vannes-Meucon Airport	FR
LFRZ	Saint-Nazaire-Montoir Airport	FR
LFSB	EuroAirport Basel-Mulhouse-Freiburg Airport	FR
LFSD	Dijon-Bourgogne Airport	FR
LFSG	Épinal-Mirecourt Airport	FR
LFSI	Saint-Dizier – Robinson Air Base	FR
LFSL	Brive-Souillac	FR
LFSM	Montbéliard-Courcelles Airfield	FR
LFSN	Nancy-Essey Airport	FR
LFSO	Nancy-Ochey (BA 133) Air Base	FR
LFST	Strasbourg Airport	FR
LFSX	Luxeuil-Saint-Sauveur (BA 116) Air Base	FR
LFTH	Toulon-Hyères Airport	FR
LFTO	Rize–Artvin Airport	TR
LFTW	Nîmes-Arles-Camargue Airport	FR
LFVM	Miquelon Airport	PM
LFVP	St Pierre Airport	PM
LFXA	Ambérieu Air Base (BA 278)	FR
LGAD	Andravida Air Base	GR
LGAL	Alexandroupoli Democritus Airport	GR
LGAV	Athens Eleftherios Venizelos International Airport	GR
LGBL	Nea Anchialos National Airport	GR
LGEL	Elefsis Airport	GR
LGHI	Chios Island National Airport	GR
LGIO	Ioannina Airport	GR
LGIR	Heraklion International Nikos Kazantzakis Airport	GR
LGKF	Kefallinia Airport	GR
LGKL	Kalamata Airport	GR
LGKO	Kos Airport	GR
LGKP	Karpathos Airport	GR
LGKR	Ioannis Kapodistrias International Airport	GR
LGKV	Kavala Alexander the Great International Airport	GR
LGKZ	Kozani State Airport Filippos	GR
LGMK	Mikonos Airport	GR
LGMT	Mytilene International Airport	GR
LGP	Bicol International Airport	PH
LGPZ	Aktion National Airport	GR
LGRP	Diagoras Airport	GR
LGRX	Patras Araxos Agamemnon Airport	GR
LGSA	Chania International Airport	GR
LGSK	Skiathos Island National Airport	GR
LGSM	Samos Airport	GR
LGSR	Santorini Airport	GR
LGST	Sitia Airport	GR
LGTG	Tanagra Air Base	GR
LGTS	Thessaloniki Macedonia International Airport	GR
LGZA	Zakynthos International Airport "Dionysios Solomos"	GR
LHBP	Budapest Liszt Ferenc International Airport	HU
LHDC	Debrecen International Airport	HU
LHKE	Kecskemét Air Base	HU
LHPP	Pécs-Pogány Airport	HU
LHPR	Győr-Pér International Airport	HU
LHSM	Hévíz–Balaton Airport	HU
LHSN	Szolnok Air Base	HU
LHTA	Taszár Air Base	HU
LHTL	Tököl Airport	HU
LIBA	Amendola Air Base	IT
LIBC	Crotone Airport	IT
LIBD	Bari Karol Wojtyła Airport	IT
LIBF	Foggia "Gino Lisa" Airport	IT
LIBG	Taranto-Grottaglie "Marcello Arlotta" Airport	IT
LIBN	Lecce Galatina Air Base	IT
LIBP	Abruzzo Airport	IT
LIBR	Brindisi Airport	IT
LIBV	Gioia Del Colle Air Base	IT
LICA	Lamezia Terme Airport	IT
LICB	Comiso Airport	IT
LICC	Catania-Fontanarossa Airport	IT
LICD	Lampedusa Airport	IT
LICG	Pantelleria Airport	IT
LICJ	Falcone–Borsellino Airport	IT
LICP	Palermo-Boccadifalco Airport	IT
LICR	Reggio Calabria Airport	IT
LICT	Vincenzo Florio Airport Trapani-Birgi	IT
LICZ	Sigonella Navy Air Base	IT
LIDT	Trento-Mattarello Airport	IT
LIEA	Alghero-Fertilia Airport	IT
LIED	Decimomannu Air Base	IT
LIEE	Cagliari Elmas Airport	IT
LIEO	Olbia Costa Smeralda Airport	IT
LIET	Tortolì Airport	IT
LILA	Alessandria Airport	IT
LILE	Biella-Cerrione Airport	IT
LILI	Vercelli Airport	IT
LILM	Casale Monferrato Airport	IT
LILN	Varese-Venegono Airport	IT
LIMA	Torino-Aeritalia Airport	IT
LIMC	Malpensa International Airport	IT
LIME	Milan Bergamo Airport	IT
LIMF	Turin Airport	IT
LIMG	Villanova D'Albenga International Airport	IT
LIMJ	Genoa Cristoforo Colombo Airport	IT
LIML	Milano Linate Airport	IT
LIMN	Cameri Air Base [MIL]	IT
LIMP	Parma Airport	IT
LIMR	Novi Ligure Airport	IT
LIMS	Piacenza San Damiano Air Base	IT
LIMW	Aosta Airport	IT
LIMZ	Cuneo International Airport	IT
LIPA	Aviano Air Base	IT
LIPB	Bolzano Airport	IT
LIPC	Cervia Air Base	IT
LIPE	Bologna Guglielmo Marconi Airport	IT
LIPH	Treviso-Sant'Angelo Airport	IT
LIPI	Rivolto Air Base	IT
LIPK	Forlì Airport	IT
LIPL	Ghedi Air Base	IT
LIPO	Brescia Airport	IT
LIPQ	Trieste–Friuli Venezia Giulia Airport	IT
LIPR	Federico Fellini International Airport	IT
LIPS	Istrana Air Base	IT
LIPU	Padova Airfield	IT
LIPX	Verona-Villafranca Valerio Catullo Airport	IT
LIPY	Marche Airport	IT
LIPZ	Venice Marco Polo Airport	IT
LIQS	Siena-Ampugnano Airport	IT
LIQW	Sarzana-Luni Air Base	IT
LIRA	Ciampino–G. B. Pastine International Airport	IT
LIRE	Pratica Di Mare Air Base	IT
LIRF	Rome–Fiumicino Leonardo da Vinci International Airport	IT
LIRG	Guidonia Air Base	IT
LIRI	Salerno Costa d'Amalfi Airport	IT
LIRJ	Marina Di Campo Airport	IT
LIRL	Latina Air Base	IT
LIRM	Grazzanise Air Base	IT
LIRN	Naples International Airport	IT
LIRP	Pisa International Airport	IT
LIRQ	Peretola Airport	IT
LIRS	Grosseto Air Base	IT
LIRU	Rome Urbe Airport	IT
LIRV	Viterbo Airport	IT
LIRZ	Perugia San Francesco d'Assisi – Umbria International Airport	IT
LJCE	Cerklje Air Base	SI
LJLJ	Ljubljana Jože Pučnik Airport	SI
LJMB	Maribor Airport	SI
LJPZ	Portorož Airport	SI
LKCV	Čáslav Air Base	CZ
LKKB	Kbely Air Base	CZ
LKKU	Kunovice Airport	CZ
LKKV	Karlovy Vary International Airport	CZ
LKLN	Plzeň-Líně Airport	CZ
LKMT	Ostrava Leos Janáček Airport	CZ
LKNA	Náměšť Air Base	CZ
LKPD	Pardubice Airport	CZ
LKPO	Přerov Air Base	CZ
LKPR	Václav Havel Airport Prague	CZ
LKTB	Brno-Tuřany Airport	CZ
LKVO	Vodochody Airport	CZ
LLBG	Ben Gurion International Airport	IL
LLEK	Tel Nof Air Base	IL
LLER	Ramon International Airport	IL
LLHA	Haifa International Airport	IL
LLIB	Rosh Pina Airport	IL
LLMZ	Bar Yehuda Airfield	IL
LLNV	Nevatim Air Base	IL
LLRD	Ramat David Air Base	IL
LLRM	Ramon Air Base	IL
LMML	Malta International Airport	MT
LOAN	Wiener Neustadt East Airport	AT
LOWG	Graz Airport	AT
LOWI	Innsbruck Airport	AT
LOWK	Klagenfurt Airport	AT
LOWL	Linz-Hörsching Airport / Vogler Air Base	AT
LOWS	Salzburg Airport	AT
LOWW	Vienna International Airport	AT
LOXZ	Hinterstoisser Air Base	AT
LPAR	Alverca Air Base	PT
LPAZ	Santa Maria Airport	PT
LPBG	Bragança Airport	PT
LPBJ	Beja Airport / Airbase	PT
LPBR	Braga Municipal Aerodrome	PT
LPCB	Aerodromo de Castelo Branco	PT
LPCO	Aerodromo Municipal de Coimbra	PT
LPCS	Cascais Airport	PT
LPEV	Évora Airfield	PT
LPFL	Flores Airport	PT
LPFR	Faro Airport	PT
LPGR	Graciosa Airport	PT
LPHR	Horta Airport	PT
LPLA	Lajes Airport	PT
LPMA	Madeira International Airport Cristiano Ronaldo	PT
LPMR	Monte Real Air Base	PT
LPMT	Montijo Air Base	PT
LPOV	Ovar Air Base	PT
LPPD	João Paulo II Airport	PT
LPPI	Pico Airport	PT
LPPM	Portimão Airport	PT
LPPR	Francisco de Sá Carneiro Airport	PT
LPPS	Porto Santo Airport	PT
LPPT	Humberto Delgado Airport (Lisbon Portela Airport)	PT
LPSJ	São Jorge Airport	PT
LPSO	Aeródromo Municipal de Ponte de Sor	PT
LPST	Sintra Air Base	PT
LPTN	Tancos Airbase	PT
LPVL	Vilar de Luz Airfield	PT
LPVR	Vila Real Airport	PT
LPVZ	Aerodromo Goncalves Lobato (Viseu Airport)	PT
LQBK	Banja Luka International Airport	BA
LQMO	Mostar International Airport	BA
LQSA	Sarajevo International Airport	BA
LQTZ	Tuzla International Airport	BA
LR79	Ianca Air Base	RO
LR80	Feteşti Air Base	RO
LR82	Boboc Air Base	RO
LRAR	Arad International Airport	RO
LRBC	Bacău Airport	RO
LRBM	Maramureș International Airport	RO
LRBS	Băneasa International Airport	RO
LRCK	Mihail Kogălniceanu International Airport	RO
LRCL	Cluj-Napoca International Airport	RO
LRCS	Caransebeş Airport	RO
LRCT	Câmpia Turzii Air Base	RO
LRCV	Craiova Airport	RO
LRIA	Iaşi Airport	RO
LROD	Oradea International Airport	RO
LROP	Henri Coandă International Airport	RO
LROV	Brașov-Ghimbav International Airport (U.C.)	RO
LRSB	Sibiu International Airport	RO
LRSM	Satu Mare Airport	RO
LRSV	Suceava Stefan cel Mare Airport	RO
LRTC	Tulcea Danube Delta Airport	RO
LRTM	Transilvania Târgu Mureş International Airport	RO
LRTR	Timişoara Traian Vuia Airport	RO
LSGC	Les Eplatures Airport	CH
LSGG	Geneva Cointrin International Airport	CH
LSGS	Sion Airport	CH
LSMA	Alpnach Air Base	CH
LSMD	Dübendorf Air Base	CH
LSME	Emmen Air Base	CH
LSMP	Payerne Air Base	CH
LSZA	Lugano Airport	CH
LSZB	Bern-Belp Airport	CH
LSZG	Grenchen Airport	CH
LSZH	Zürich Airport	CH
LSZR	St Gallen Altenrhein Airport	CH
LSZS	Samedan Airport	CH
LTAC	Esenboğa International Airport	TR
LTAD	Etimesgut Air Base	TR
LTAE	Akıncı Air Base	TR
LTAF	Adana Şakirpaşa Airport	TR
LTAG	İncirlik Air Base	TR
LTAH	Afyon Air Base	TR
LTAI	Antalya International Airport	TR
LTAJ	Gaziantep International Airport	TR
LTAL	Kastamonu Airport	TR
LTAN	Konya Airport	TR
LTAS	Zonguldak Çaycuma Airport	TR
LTAT	Malatya Erhaç Airport	TR
LTAU	Kayseri Erkilet Airport	TR
LTAV	Sivrihisar Airport	TR
LTAW	Tokat Airport	TR
LTAY	Çardak Airport	TR
LTBA	İstanbul Atatürk Airport	TR
LTBF	Balıkesir Merkez Airport	TR
LTBG	Bandırma Airport	TR
LTBH	Çanakkale Airport	TR
LTBI	Eskişehir Air Base	TR
LTBJ	Adnan Menderes International Airport	TR
LTBL	Çiğli Airport	TR
LTBQ	Cengiz Topel Airport	TR
LTBR	Bursa Yenişehir Airport	TR
LTBS	Dalaman International Airport	TR
LTBT	Akhisar Airport	TR
LTBU	Tekirdağ Çorlu Airport	TR
LTBX	İstanbul Samandıra Army Air Base	TR
LTBY	Anadolu Airport	TR
LTCA	Elazığ Airport	TR
LTCB	Ordu–Giresun Airport	TR
LTCC	Diyarbakır Airport	TR
LTCD	Erzincan Airport	TR
LTCE	Erzurum International Airport	TR
LTCF	Kars Airport	TR
LTCG	Trabzon International Airport	TR
LTCI	Van Ferit Melen Airport	TR
LTCJ	Batman Airport	TR
LTCK	Muş Airport	TR
LTCL	Siirt Airport	TR
LTCM	Sinop Airport	TR
LTCN	Kahramanmaraş Airport	TR
LTCO	Ağrı Airport	TR
LTCP	Adıyaman Airport	TR
LTCR	Mardin Airport	TR
LTCS	Şanlıurfa GAP Airport	TR
LTCT	Iğdır Airport	TR
LTCV	Şırnak Şerafettin Elçi Airport	TR
LTCW	Hakkari Yüksekova Airport	TR
LTDA	Hatay Airport	TR
LTFC	Süleyman Demirel International Airport	TR
LTFD	Balıkesir Koca Seyit Airport	TR
LTFE	Milas Bodrum International Airport	TR
LTFG	Gazipaşa-Alanya Airport	TR
LTFH	Samsun-Çarşamba Airport	TR
LTFJ	Istanbul Sabiha Gökçen International Airport	TR
LTFM	İstanbul Airport	TR
LUBL	Bălți International Airport	MD
LUBM	Mărculeşti International Airport	MD
LUCH	Cahul International Airport	MD
LUKK	Chişinău International Airport	MD
LUTR	Tiraspol Airport	MD
LWOH	Ohrid St. Paul the Apostle Airport	MK
LWSK	Skopje International Airport	MK
LXGB	Gibraltar Airport	GI
LY-BCQ	Brak Airport	LY
LY88	Ponikve Airport	RS
LYBE	Belgrade Nikola Tesla Airport	RS
LYBT	Batajnica Air Base	RS
LYKV	Morava Airport	RS
LYNI	Nis Airport	RS
LYPG	Podgorica Airport / Podgorica Golubovci Airbase	ME
LYTV	Tivat Airport	ME
LZG	Langzhong Gucheng Airport	CN
LZIB	M. R. Štefánik Airport	SK
LZKZ	Košice Airport	SK
LZMC	Kuchyňa Air Base	SK
LZPP	Piešťany Airport	SK
LZSL	Sliač Airport	SK
LZTT	Poprad-Tatry Airport	SK
LZZI	Žilina Airport	SK
MA-0003	Mahbes Airbase	MA
MBGT	JAGS McCartney International Airport	TC
MBNC	North Caicos Airport	TC
MBPV	Providenciales International Airport	TC
MBSC	South Caicos Airport	TC
MDBH	Maria Montez International Airport	DO
MDCR	Cabo Rojo Airport	DO
MDCY	Samaná El Catey International Airport	DO
MDJB	La Isabela International Airport	DO
MDLR	Casa De Campo International Airport	DO
MDPC	Punta Cana International Airport	DO
MDPP	Gregorio Luperon International Airport	DO
MDSD	Las Américas International Airport	DO
MDSI	San Isidro Air Base	DO
MDST	Cibao International Airport	DO
MGCB	Coban Airport	GT
MGGT	La Aurora Airport	GT
MGPB	Puerto Barrios Airport	GT
MGRB	Rubelsanto Airport	GT
MGRT	Retalhuleu Airport	GT
MGSJ	San José Airport	GT
MGTK	Mundo Maya International Airport	GT
MHLC	Goloson International Airport	HN
MHLM	Ramón Villeda Morales International Airport	HN
MHNJ	La Laguna Airport	HN
MHRO	Juan Manuel Gálvez International Airport	HN
MHSC	Palmerola International Airport / José Enrique Soto Cano Air Base	HN
MHTE	Tela Airport	HN
MHTG	Toncontín International Airport	HN
MHTJ	Trujillo Airport	HN
MKBS	Ian Fleming International Airport	JM
MKJP	Norman Manley International Airport	JM
MKJS	Sangster International Airport	JM
MKKJ	Ken Jones Airport	JM
MKTP	Tinson Pen Airport	JM
MMAA	Aeropuerto Internacional Juan N. Álvarez	MX
MMAN	Del Norte International Airport	MX
MMAS	Governor Jesús Terán Peredo International Airport	MX
MMBT	Bahías de Huatulco International Airport	MX
MMCB	Cuernavaca - General Mariano Matamoros Airport	MX
MMCE	Ciudad del Carmen International Airport	MX
MMCL	Bachigualato Federal International Airport	MX
MMCM	Chetumal International Airport	MX
MMCN	Ciudad Obregón International Airport	MX
MMCP	Ingeniero Alberto Acuña Ongay International Airport	MX
MMCS	Abraham González International Airport	MX
MMCT	Chichen Itza International Airport	MX
MMCU	General Roberto Fierro Villalobos International Airport	MX
MMCV	General Pedro Jose Mendez International Airport	MX
MMCY	Captain Rogelio Castillo National Airport	MX
MMCZ	Aeropuerto Internacional de Cozumel	MX
MMDA	Ciudad Constitución National Airport	MX
MMDO	Aeropuerto Internacional Gral, Guadalupe Victoria	MX
MMEP	Amado Nervo National Airport	MX
MMGL	Aeropuerto Internacional Miguel Hidalgo	MX
MMGM	General José María Yáñez International Airport	MX
MMHO	General Ignacio P. Garcia International Airport	MX
MMIA	Licenciado Miguel de la Madrid Airport	MX
MMIO	Plan De Guadalupe International Airport	MX
MMIT	Ixtepec Airport	MX
MMJA	El Lencero Airport	MX
MMLC	Lázaro Cárdenas Airport	MX
MMLM	Valle del Fuerte International Airport	MX
MMLO	Aeropuerto Internacional Del Bajío	MX
MMLP	Manuel Márquez de León International Airport	MX
MMLT	Loreto International Airport	MX
MMMA	General Servando Canales International Airport	MX
MMMD	Aeropuerto Internacional Manuel Crescencio Rejón	MX
MMML	General Rodolfo Sánchez Taboada International Airport	MX
MMMM	General Francisco J. Mujica International Airport	MX
MMMT	Minatitlán/Coatzacoalcos International Airport	MX
MMMV	Monclova International Airport	MX
MMMX	Aeropuerto Internacional Lic. Benito Juárez	MX
MMMY	Aeropuerto Internacional Gral. Mariano Escobedo	MX
MMMZ	Aeropuerto Internacional Gral. Rafael Buelna	MX
MMNL	Quetzalcóatl International Airport	MX
MMOX	Xoxocotlán International Airport	MX
MMPA	El Tajín National Airport	MX
MMPB	Hermanos Serdán International Airport	MX
MMPG	Piedras Negras International Airport	MX
MMPN	Uruapan - Licenciado y General Ignacio Lopez Rayon International Airport	MX
MMPR	Aeropuerto Internacional Lic. Gustavo Díaz Ordaz	MX
MMPS	Puerto Escondido International Airport	MX
MMQT	Querétaro Intercontinental Airport	MX
MMRX	General Lucio Blanco International Airport	MX
MMSD	Aeropuerto Internacional de Los Cabos	MX
MMSL	Cabo San Lucas International Airport	MX
MMSM	General Felipe Ángeles International Airport	MX
MMSP	Ponciano Arriaga International Airport	MX
MMTB	Terán Air Base	MX
MMTC	Francisco Sarabia Tinoco International Airport	MX
MMTG	Angel Albino Corzo International Airport	MX
MMTJ	Aeropuerto Internacional Gral. Abelardo Rodriguez	MX
MMTM	General Francisco Javier Mina International Airport	MX
MMTO	Aeropuerto Internacional Adolfo López Mateos	MX
MMTP	Tapachula International Airport	MX
MMUN	Aeropuerto Internacional de Cancún	MX
MMVA	Carlos Rovirosa Pérez International Airport	MX
MMVR	General Heriberto Jara International Airport	MX
MMZC	General Leobardo C. Ruiz International Airport	MX
MMZH	Ixtapa Zihuatanejo International Airport	MX
MMZO	Playa De Oro International Airport	MX
MNBL	Bluefields Airport	NI
MNMG	Augusto C. Sandino (Managua) International Airport	NI
MNPC	Puerto Cabezas Airport	NI
MPBO	Bocas del Toro International Airport	PA
MPCE	Alonso Valderrama Airport	PA
MPCH	Changuinola Captain Manuel Niño International Airport	PA
MPDA	Enrique Malek International Airport	PA
MPEJ	Enrique Adolfo Jimenez Airport	PA
MPMG	Marcos A. Gelabert International Airport	PA
MPSA	Ruben Cantu Airport	PA
MPTO	Tocumen International Airport	PA
MRAO	Aerotortuguero Airport	CR
MRBA	Buenos Aires Airport	CR
MRBC	Barra del Colorado Airport	CR
MRCC	Coto 47 Airport	CR
MRGF	Golfito Airport	CR
MRGP	Guapiles Airport	CR
MRLB	Guanacaste Airport	CR
MRLC	Los Chiles Airport	CR
MRLM	Limon International Airport	CR
MRNS	Nosara Airport	CR
MROC	Juan Santamaría International Airport	CR
MRPJ	Puerto Jimenez Airport	CR
MRPM	Palmar Sur Airport	CR
MRPV	Tobías Bolaños International Airport	CR
MRQP	Quepos Managua Airport	CR
MRSV	San Vito De Java Airport	CR
MRUP	Upala Airport	CR
MSLP	Monseñor Óscar Arnulfo Romero International Airport	SV
MSSS	Ilopango International Airport	SV
MTCA	Les Cayes Airport	HT
MTCH	Cap Haitien International Airport	HT
MTJA	Jacmel Airport	HT
MTJE	Jérémie Airport	HT
MTPP	Toussaint Louverture International Airport	HT
MTPX	Port-de-Paix Airport	HT
MUBA	Gustavo Rizo Airport	CU
MUBY	Carlos Manuel de Cespedes Airport	CU
MUCA	Maximo Gomez Airport	CU
MUCC	Jardines Del Rey Airport	CU
MUCF	Jaime Gonzalez Airport	CU
MUCL	Vilo Acuña International Airport	CU
MUCM	Ignacio Agramonte International Airport	CU
MUCU	Antonio Maceo International Airport	CU
MUGM	Leeward Point Field	CU
MUGT	Mariana Grajales Airport	CU
MUHA	José Martí International Airport	CU
MUHG	Frank Pais International Airport	CU
MUKW	Kawama Airport	CU
MULM	La Coloma Airport	CU
MUMO	Orestes Acosta Airport	CU
MUMZ	Sierra Maestra International Airport	CU
MUNB	San Nicolás de Bari Airport	CU
MUNG	Rafael Cabrera Airport	CU
MUPB	Playa Baracoa Airport	CU
MUSC	Abel Santamaria Airport	CU
MUSJ	San Julián Air Base	CU
MUSN	Siguanea Airport	CU
MUTD	Alberto Delgado Airport	CU
MUVR	Juan Gualberto Gomez International Airport	CU
MUVT	Hermanos Ameijeiras Airport	CU
MWCB	Charles Kirkconnell International Airport	KY
MWCL	Edward Bodden Little Cayman Airfield	KY
MWCR	Owen Roberts International Airport	KY
MX-0424	Creel International Airport	MX
MYAB	Clarence A. Bain Airport	BS
MYAF	Andros Town Airport	BS
MYAK	Congo Town Airport	BS
MYAM	Leonard M Thompson International Airport	BS
MYAN	San Andros Airport	BS
MYAP	Spring Point Airport	BS
MYAT	Treasure Cay Airport	BS
MYBC	Chub Cay Airport	BS
MYBG	Great Harbour Cay Airport	BS
MYBS	South Bimini Airport	BS
MYCA	Arthur's Town Airport	BS
MYCB	New Bight Airport	BS
MYCI	Colonel Hill Airport	BS
MYEF	Exuma International Airport	BS
MYEH	North Eleuthera Airport	BS
MYEM	Governor's Harbour Airport	BS
MYEN	Normans Cay Airport	BS
MYER	Rock Sound Airport	BS
MYES	Staniel Cay Airport	BS
MYGF	Grand Bahama International Airport	BS
MYIG	Inagua Airport	BS
MYLD	Deadman's Cay Airport	BS
MYLR	Hard Bargain Airport	BS
MYLS	Stella Maris Airport	BS
MYMM	Mayaguana Airport	BS
MYNN	Lynden Pindling International Airport	BS
MYRD	Duncan Town Airport	BS
MYSM	San Salvador Airport	BS
MZBZ	Philip S. W. Goldson International Airport	BZ
NBS	Changbaishan Airport	CN
NCRG	Rarotonga International Airport	CK
NFFN	Nadi International Airport	FJ
NFNA	Nausori International Airport	FJ
NFNL	Labasa Airport	FJ
NFTF	Fua'amotu International Airport	TO
NFTL	Lifuka Island Airport	TO
NFTV	Vava'u International Airport	TO
NG-0003	Gombe Lawanti International Airport	NG
NG-QRW	Warri Airport	NG
NGFU	Funafuti International Airport	TV
NGTA	Bonriki International Airport	KI
NGTE	Tabiteuea North Airport	KI
NIUE	Niue International Airport	NU
NLH	Ninglang Luguhu Airport	CN
NLWF	Pointe Vele Airport	WF
NLWW	Hihifo Airport	WF
NP-0003	Pokhara International Airport	NP
NSFA	Faleolo International Airport	WS
NSFQ	Fitiuta Airport	AS
NSTU	Pago Pago International Airport	AS
NTAA	Faa'a International Airport	PF
NTAR	Rurutu Airport	PF
NTAT	Tubuai Airport	PF
NTGA	Anaa Airport	PF
NTGB	Fangatau Airport	PF
NTGC	Tikehau Airport	PF
NTGE	Reao Airport	PF
NTGF	Fakarava Airport	PF
NTGI	Manihi Airport	PF
NTGJ	Totegegie Airport	PF
NTGK	Kaukura Airport	PF
NTGM	Makemo Airport	PF
NTGP	Puka Puka Airport	PF
NTGT	Takapoto Airport	PF
NTGU	Arutua Airport	PF
NTGV	Mataiva Airport	PF
NTHE	Ahe Airport	PF
NTKR	Takaroa Airport	PF
NTMD	Nuku Hiva Airport	PF
NTMN	Hiva Oa-Atuona Airport	PF
NTTB	Bora Bora Airport	PF
NTTG	Rangiroa Airport	PF
NTTH	Huahine-Fare Airport	PF
NTTM	Moorea Temae Airport	PF
NTTO	Hao Airport	PF
NTTP	Maupiti Airport	PF
NTTR	Raiatea Airport	PF
NVSQ	Gaua Island Airport	VU
NVSS	Santo Pekoa International Airport	VU
NVVV	Bauerfield International Airport	VU
NVVW	Tanna Airport	VU
NWWA	Tiga Airport	NC
NWWC	Île Art - Waala Airport	NC
NWWD	Koné Airport	NC
NWWE	Île des Pins Airport	NC
NWWK	Koumac Airport	NC
NWWL	Lifou Airport	NC
NWWM	Nouméa Magenta Airport	NC
NWWR	Maré Airport	NC
NWWU	Touho Airport	NC
NWWV	Ouvéa Airport	NC
NWWW	La Tontouta International Airport	NC
NZAA	Auckland International Airport	NZ
NZAP	Taupo Airport	NZ
NZAR	Ardmore Airport	NZ
NZCH	Christchurch International Airport	NZ
NZCI	Chatham Islands / Tuuta Airport	NZ
NZDN	Dunedin International Airport	NZ
NZGS	Gisborne Airport	NZ
NZGT	Glentanner Airport	NZ
NZHK	Hokitika Airfield	NZ
NZHN	Hamilton International Airport	NZ
NZKK	Kerikeri Airport	NZ
NZKT	Kaitaia Airport	NZ
NZLX	Alexandra Aerodrome	NZ
NZMC	Mount Cook Airport	NZ
NZMO	Manapouri Airport	NZ
NZMS	Hood Airport	NZ
NZNP	New Plymouth Airport	NZ
NZNR	Hawke's Bay Airport	NZ
NZNS	Nelson Airport	NZ
NZNV	Invercargill Airport	NZ
NZOH	RNZAF Base Ohakea	NZ
NZOU	Oamaru Airport	NZ
NZPM	Palmerston North Airport	NZ
NZPP	Paraparaumu Airport	NZ
NZQN	Queenstown International Airport	NZ
NZRO	Rotorua Regional Airport	NZ
NZSP	South Pole Station Airport	AQ
NZTG	Tauranga Airport	NZ
NZTU	Timaru Airport	NZ
NZUK	Pukaki Airport	NZ
NZWB	Woodbourne Airport	NZ
NZWD	Williams Field	AQ
NZWF	Wanaka Airport	NZ
NZWK	Whakatane Airport	NZ
NZWN	Wellington International Airport	NZ
NZWO	Wairoa Airport	NZ
NZWP	RNZAF Base Auckland-Whenuapai	NZ
NZWR	Whangarei Airport	NZ
NZWS	Westport Airport	NZ
NZWU	Wanganui Airport	NZ
OAHR	Herat - Khwaja Abdullah Ansari International Airport	AF
OAIX	Bagram Airfield	AF
OAJL	Jalalabad Airport	AF
OAKB	Kabul International Airport	AF
OAKN	Ahmad Shah Baba International Airport / Kandahar Airfield	AF
OAMN	Maymana Zahiraddin Faryabi Airport	AF
OAMS	Mazar-i-Sharif International Airport	AF
OAUZ	Kunduz Airport	AF
OBBI	Bahrain International Airport	BH
OBBS	Sheik Isa Air Base	BH
OEAB	Abha International Airport	SA
OEAH	Al-Ahsa International Airport	SA
OEBA	King Saud Bin Abdulaziz (Al Baha) Airport	SA
OEBH	Bisha Airport	SA
OEDF	King Fahd International Airport	SA
OEDM	King Salman Abdulaziz Airport	SA
OEDR	King Abdulaziz Air Base	SA
OEGN	Jizan Regional Airport / King Abdullah bin Abdulaziz Airport	SA
OEGS	Gassim Airport	SA
OEGT	Gurayat Domestic Airport	SA
OEHL	Ha'il Airport	SA
OEJB	Jubail Airport	SA
OEJF	King Faisal Naval Base	SA
OEJN	King Abdulaziz International Airport	SA
OEKK	King Khaled Military City Airport	SA
OEKM	King Khalid Air Base	SA
OEMA	Prince Mohammad Bin Abdulaziz Airport	SA
OENG	Najran Domestic Airport	SA
OENN	Neom Bay Airport	SA
OEPA	Al Qaisumah/Hafr Al Batin Airport	SA
OEPS	Prince Sultan Air Base	SA
OERF	Rafha Domestic Airport	SA
OERK	King Khaled International Airport	SA
OERM	Ras Mishab Airport	SA
OERR	Arar Domestic Airport	SA
OERT	Ras Tanura Airport	SA
OERY	Riyadh Air Base	SA
OESH	Sharurah Domestic Airport	SA
OESK	Al-Jawf Domestic Airport	SA
OETB	Tabuk Airport	SA
OETF	Ta’if Regional Airport	SA
OETN	Ras Tanajib Airport	SA
OETR	Turaif Domestic Airport	SA
OEWD	Wadi Al Dawasir Domestic Airport	SA
OEWJ	Al Wajh Domestic Airport	SA
OEYN	Yanbu Airport / Prince Abdul Mohsin bin Abdulaziz international Airport	SA
OIAA	Abadan Airport	IR
OIAD	Dezful Airport	IR
OIAG	Aghajari Airport	IR
OIAH	Gachsaran Airport	IR
OIAI	Shahid Asiyaee Airport	IR
OIAM	Mahshahr Airport	IR
OIAW	Lieutenant General Qasem Soleimani International Airport	IR
OIBA	Abu Musa Island Airport	IR
OIBB	Bushehr Airport	IR
OIBJ	Jam Airport	IR
OIBK	Kish International Airport	IR
OIBL	Bandar Lengeh International Airport	IR
OIBP	Persian Gulf International Airport	IR
OIBQ	Khark Airport	IR
OIBS	Siri Airport	IR
OIBV	Lavan Airport	IR
OICC	Shahid Ashrafi Esfahani Airport	IR
OICI	Ilam Airport	IR
OICK	Khoram Abad Airport	IR
OICS	Sanandaj Airport	IR
OIFK	Kashan Airport	IR
OIFM	Isfahan Shahid Beheshti International Airport	IR
OIFP	Badr Air Base	IR
OIFS	Shahrekord Airport	IR
OIGG	Sardar-e-Jangal Airport	IR
OIHH	Hamadan Airport	IR
OIHS	Nojeh Air Base	IR
OIIE	Imam Khomeini International Airport	IR
OIII	Mehrabad International Airport	IR
OIIK	Qazvin Airport	IR
OIIM	Naja Airport	IR
OIIP	Payam Karaj International Airport	IR
OIKB	Bandar Abbas International Airport	IR
OIKJ	Jiroft Airport	IR
OIKK	Ayatollah Hashemi Rafsanjani International Airport	IR
OIKM	Bam Airport	IR
OIKR	Rafsanjan Airport	IR
OIKY	Sirjan Airport	IR
OIMB	Birjand International Airport	IR
OIMC	Sarakhs Airport	IR
OIMM	Mashhad International Airport	IR
OIMN	Bojnord Airport	IR
OIMS	Sabzevar National Airport	IR
OIMT	Tabas Airport	IR
OING	Gorgan Airport	IR
OINN	Nowshahr Airport	IR
OINR	Ramsar Airport	IR
OINZ	Sari Dasht-e Naz International Airport	IR
OISF	Fasa Airport	IR
OISL	Lar Airport	IR
OISR	Lamerd Airport	IR
OISS	Shiraz Shahid Dastghaib International Airport	IR
OISY	Yasuj Airport	IR
OITL	Ardabil Airport	IR
OITR	Urmia Airport	IR
OITT	Tabriz International Airport	IR
OITZ	Zanjan Airport	IR
OIYY	Shahid Sadooghi Airport	IR
OIZB	Zabol Airport	IR
OIZC	Chabahar Konarak International Airport	IR
OIZH	Zahedan International Airport	IR
OIZI	Iranshahr Airport	IR
OJAI	Queen Alia International Airport	JO
OJAM	Amman Civil (Marka International) Airport	JO
OJAQ	Aqaba King Hussein International Airport	JO
OJMS	Muwaffaq Salti Air Base	JO
OKAJ	Ahmed Al Jaber Air Base	KW
OKAS	Ali Al Salem Air Base	KW
OKBK	Kuwait International Airport	KW
OLBA	Beirut Rafic Hariri International Airport	LB
OLKA	Rene Mouawad Air Base / Kleyate Airport	LB
OLRA	Rayak Air Base	LB
OM-0003	Duqm International Airport	OM
OM-0004	Mussanah Airport	OM
OM-0007	Ras Al Hadd Airport	OM
OMAA	Abu Dhabi International Airport	AE
OMAD	Al Bateen Executive Airport	AE
OMAL	Al Ain International Airport	AE
OMAM	Al Dhafra Air Base	AE
OMBY	Sir Bani Yas Airport	AE
OMDB	Dubai International Airport	AE
OMDM	Al Minhad Air Base	AE
OMDW	Al Maktoum International Airport	AE
OMFJ	Fujairah International Airport	AE
OMRK	Ras Al Khaimah International Airport	AE
OMSJ	Sharjah International Airport	AE
OOKB	Khasab Airport	OM
OOMA	RAFO Masirah	OM
OOMS	Muscat International Airport	OM
OOSA	Salalah Airport	OM
OOTH	Thumrait Air Base	OM
OP12	Shamsi Airfield	PK
OPBW	Bahawalpur Airport	PK
OPCH	Chitral Airport	PK
OPDG	Dera Ghazi Khan Airport	PK
OPDI	Dera Ismael Khan Airport	PK
OPFA	Faisalabad International Airport	PK
OPGD	Gwadar International Airport	PK
OPGT	Gilgit Airport	PK
OPIS	Islamabad International Airport	PK
OPJA	Shahbaz Air Base	PK
OPKC	Jinnah International Airport	PK
OPLA	Allama Iqbal International Airport	PK
OPLH	Walton Airport	PK
OPMA	Mangla Airport	PK
OPMF	Muzaffarabad Airport	PK
OPMI	Mianwali Air Base	PK
OPMJ	Moenjodaro Airport	PK
OPMR	Masroor Air Base	PK
OPMS	Minhas Air Base	PK
OPMT	Multan International Airport	PK
OPNH	Shaheed Benazirabad Airport	PK
OPPG	Panjgur Airport	PK
OPPI	Pasni Airport	PK
OPPS	Peshawar International Airport	PK
OPQT	Quetta International Airport	PK
OPRK	Shaikh Zaid Airport	PK
OPRQ	Rafiqui Air Base	PK
OPRS	Risalpur Air Base	PK
OPRT	Rawalakot Airport	PK
OPSD	Skardu Airport	PK
OPSF	Faisal Air Base	PK
OPSK	Sukkur Airport	PK
OPSN	Sehwan Sharif Airport	PK
OPSR	Mushaf Air Base	PK
OPSS	Saidu Sharif Airport	PK
OPST	Sialkot International Airport	PK
OPSU	Sui Airport	PK
OPTU	Turbat International Airport	PK
OPZB	Zhob Airport	PK
ORAA	Al Asad Air Base	IQ
ORAT	Al Taqaddum Air Base	IQ
ORBD	Balad Southeast Airport / Joint Base Balad	IQ
ORBI	Baghdad International Airport / New Al Muthana Air Base	IQ
ORBM	Mosul International Airport	IQ
ORER	Erbil International Airport	IQ
ORKK	Kirkuk Air Base	IQ
ORMM	Basra International Airport	IQ
ORNI	Al Najaf International Airport	IQ
ORQW	Qayyarah West Airport	IQ
ORSH	Al Sahra Army Air Field	IQ
ORSU	Sulaymaniyah International Airport	IQ
ORTF	Tall Afar Army Air Field	IQ
ORTI	Al Taji Army Air Field	IQ
ORTL	Ali Air Base	IQ
ORUB	Ubaydah Bin Al Jarrah Airport	IQ
OS57	Abu ad Duhur Air Base	SY
OS64	An Nasiriyah Air Base	SY
OS69	Khalkhalah Air Base	SY
OS70	Al Qusayr Air Base	SY
OSAP	Aleppo International Airport	SY
OSDI	Damascus International Airport	SY
OSDZ	Deir ez-Zor Airport	SY
OSKL	Qamishli Airport	SY
OSLK	Bassel Al-Assad International Airport	SY
OSPR	Palmyra Airport	SY
OTBD	Doha International Airport	QA
OTBH	Al Udeid Air Base	QA
OTHH	Hamad International Airport	QA
OY74	Al Anad Air Base	YE
OYAA	Aden International Airport	YE
OYAT	Ataq Airport	YE
OYGD	Al Ghaydah International Airport	YE
OYHD	Hodeidah International Airport	YE
OYRN	Riyan Mukalla International Airport	YE
OYSN	Sana'a International Airport	YE
OYSQ	Socotra International Airport	YE
OYSY	Seiyun Hadhramaut International Airport	YE
OYTZ	Ta'izz International Airport	YE
OZG	Zagora Airport	MA
PAAQ	Warren "Bud" Woods Palmer Municipal Airport	US
PABA	Barter Island Long Range Radar Station Airport	US
PABE	Bethel Airport	US
PABI	Allen Army Airfield	US
PABL	Buckland Airport	US
PABR	Wiley Post Will Rogers Memorial Airport	US
PABT	Bettles Airport	US
PABV	Birchwood Airport	US
PACD	Cold Bay Airport	US
PACL	Clear Airport	US
PACM	Scammon Bay Airport	US
PACV	Merle K (Mudhole) Smith Airport	US
PACZ	Cape Romanzof LRRS Airport	US
PADE	Deering Airport	US
PADK	Adak Airport	US
PADL	Dillingham Airport	US
PADM	Marshall Don Hunter Sr Airport	US
PADQ	Kodiak Airport	US
PADU	Tom Madsen (Dutch Harbor) Airport	US
PAED	Elmendorf Air Force Base	US
PAEH	Cape Newenham LRRS Airport	US
PAEI	Eielson Air Force Base	US
PAEM	Emmonak Airport	US
PAEN	Kenai Municipal Airport	US
PAFA	Fairbanks International Airport	US
PAFB	Ladd Army Airfield	US
PAFE	Kake Airport	US
PAFM	Ambler Airport	US
PAGA	Edward G. Pitka Sr Airport	US
PAGK	Gulkana Airport	US
PAGM	Gambell Airport	US
PAGS	Gustavus Airport	US
PAHC	Holy Cross Airport	US
PAHL	Huslia Airport	US
PAHN	Haines Airport	US
PAHO	Homer Airport	US
PAHP	Hooper Bay Airport	US
PAII	Egegik Airport	US
PAIK	Bob Baker Memorial Airport	US
PAIL	Iliamna Airport	US
PAIM	Indian Mountain LRRS Airport	US
PAJN	Juneau International Airport	US
PAKN	King Salmon Airport	US
PAKP	Anaktuvuk Pass Airport	US
PAKT	Ketchikan International Airport	US
PAKW	Klawock Airport	US
PALU	Cape Lisburne LRRS Airport	US
PAMC	McGrath Airport	US
PAMR	Merrill Field	US
PAMY	Mekoryuk Airport	US
PANC	Ted Stevens Anchorage International Airport	US
PANI	Aniak Airport	US
PANN	Nenana Municipal Airport	US
PANT	Annette Island Airport	US
PANV	Anvik Airport	US
PAOM	Nome Airport	US
PAOR	Northway Airport	US
PAOT	Ralph Wien Memorial Airport	US
PAPB	St George Airport	US
PAPC	Port Clarence Coast Guard Station	US
PAPG	Petersburg James A Johnson Airport	US
PAPH	Port Heiden Airport	US
PAPM	Platinum Airport	US
PAQT	Nuiqsut Airport	US
PARC	Arctic Village Airport	US
PARY	Ruby Airport	US
PASA	Savoonga Airport	US
PASC	Deadhorse Airport	US
PASD	Sand Point Airport	US
PASH	Shishmaref Airport	US
PASI	Sitka Rocky Gutierrez Airport	US
PASM	St Mary's Airport	US
PASN	St Paul Island Airport	US
PASV	Sparrevohn LRRS Airport	US
PASX	Soldotna Airport	US
PASY	Eareckson Air Station	US
PATG	Togiak Airport	US
PATK	Talkeetna Airport	US
PATL	Tatalina LRRS Airport	US
PATQ	Atqasuk Edward Burnell Sr Memorial Airport	US
PAVD	Valdez Pioneer Field	US
PAVL	Kivalina Airport	US
PAWD	Seward Airport	US
PAWG	Wrangell Airport	US
PAWI	Wainwright Airport	US
PAWN	Noatak Airport	US
PAWS	Wasilla Airport	US
PAYA	Yakutat Airport	US
PCIS	Canton Island Airport	KI
PFYU	Fort Yukon Airport	US
PG-OPU	Balimo Airport	PG
PG-VMU	Baimuru Airport	PG
PGRO	Rota International Airport	MP
PGSN	Saipan International Airport	MP
PGUA	Andersen Air Force Base	GU
PGUM	Antonio B. Won Pat International Airport	GU
PGWT	Tinian International Airport	MP
PH-0001	Laguindingan International Airport	PH
PH-0073	Cagayan North International Airport	PH
PH-0462	Central Mindanao Airport	PH
PHBK	Barking Sands Airport	US
PHHN	Hana Airport	US
PHIK	Hickam Air Force Base	US
PHJH	Kapalua Airport	US
PHJR	Kalaeloa Airport	US
PHKO	Ellison Onizuka Kona International Airport at Keahole	US
PHLI	Lihue Airport	US
PHMK	Molokai Airport	US
PHMU	Waimea Kohala Airport	US
PHNG	Kaneohe Bay MCAS (Marion E. Carl Field) Airport	US
PHNL	Daniel K Inouye International Airport	US
PHNY	Lanai Airport	US
PHOG	Kahului Airport	US
PHTO	Hilo International Airport	US
PKMJ	Marshall Islands International Airport	MH
PKSA	Kaieteur International Airport	GY
PKWA	Bucholz Army Air Field	MH
PLCH	Cassidy International Airport	KI
PMDY	Henderson Field	UM
PPIZ	Point Lay LRRS Airport	US
PTKK	Chuuk International Airport	FM
PTPN	Pohnpei International Airport	FM
PTRO	Babelthuap Airport	PW
PTSA	Kosrae International Airport	FM
PTYA	Yap International Airport	FM
PWAK	Wake Island Airfield	UM
PY-0002	Aeropuerto Nacional de Coronel Oviedo	PY
PY-0043	Aeropuerto Nacional de Mayor Infante Rivarola	PY
PY-OLK	Aeropuerto Nacional de Fuerte Olimpo	PY
RCAY	Gangshan Air Force Base	TW
RCBS	Kinmen Airport	TW
RCDC	Pingtung South Airport	TW
RCDI	Longtan Air Base	TW
RCFG	Matsu Nangan Airport	TW
RCFN	Taitung Airport	TW
RCKH	Kaohsiung International Airport	TW
RCKU	Chiayi Airport	TW
RCKW	Hengchun Airport	TW
RCLY	Lanyu Airport	TW
RCMQ	Taichung International Airport / Ching Chuang Kang Air Base	TW
RCMT	Matsu Beigan Airport	TW
RCNN	Tainan International Airport / Tainan Air Base	TW
RCPO	Hsinchu Air Base	TW
RCQC	Penghu Magong Airport	TW
RCQS	Chihhang Air Base	TW
RCSQ	Pingtung North Airport	TW
RCSS	Taipei Songshan Airport	TW
RCTP	Taiwan Taoyuan International Airport	TW
RCYU	Hualien Airport	TW
RJAA	Narita International Airport	JP
RJAF	Shinshu-Matsumoto Airport	JP
RJAH	Ibaraki Airport / JASDF Hyakuri Air Base	JP
RJAW	Iwo Jima Airbase	JP
RJBB	Kansai International Airport	JP
RJBD	Nanki Shirahama Airport	JP
RJBE	Kobe Airport	JP
RJBT	Konotori Tajima Airport	JP
RJCB	Tokachi-Obihiro Airport	JP
RJCC	New Chitose Airport	JP
RJCH	Hakodate Airport	JP
RJCJ	JASDF Chitose Air Base	JP
RJCK	Kushiro Airport	JP
RJCM	Memanbetsu Airport	JP
RJCN	Nakashibetsu Airport	JP
RJCO	Sapporo Okadama Airport	JP
RJCS	JASDF Kenebetsu Airfield	JP
RJCT	Tokachi Airport	JP
RJCW	Wakkanai Airport	JP
RJDB	Iki Airport	JP
RJDC	Yamaguchi Ube Airport	JP
RJDT	Tsushima Airport	JP
RJEB	Monbetsu Airport	JP
RJEC	Asahikawa Airport	JP
RJEO	Okushiri Airport	JP
RJER	Rishiri Airport	JP
RJFA	JASDF Ashiya Air Base	JP
RJFC	Yakushima Airport	JP
RJFE	Fukue Airport	JP
RJFF	Fukuoka Airport	JP
RJFG	New Tanegashima Airport	JP
RJFK	Kagoshima Airport	JP
RJFM	Miyazaki Airport	JP
RJFO	Oita Airport	JP
RJFR	Kitakyushu Airport	JP
RJFS	Saga Airport	JP
RJFT	Kumamoto Airport	JP
RJFU	Nagasaki Airport	JP
RJFY	JMSDF Kanoya Air Base	JP
RJFZ	JASDF Tsuiki Air Base	JP
RJGG	Chubu Centrair International Airport	JP
RJKA	Amami Airport	JP
RJKB	Okinoerabu Airport	JP
RJKI	Kikai Airport	JP
RJKN	Tokunoshima Airport	JP
RJNA	Nagoya Airport / JASDF Komaki Air Base	JP
RJNF	Fukui Airport	JP
RJNG	Gifu Airport	JP
RJNH	JASDF Hamamatsu Air Base	JP
RJNK	Komatsu Airport / JASDF Komatsu Air Base	JP
RJNO	Oki Global Geopark Airport	JP
rjns	Mount Fuji Shizuoka Airport	JP
RJNT	Toyama Airport	JP
RJNW	Noto Satoyama Airport	JP
RJNY	JASDF Shizuhama Air Base	JP
RJOA	Hiroshima Airport	JP
RJOB	Okayama Momotaro Airport	JP
RJOC	Izumo Enmusubi Airport	JP
RJOF	JASDF Hofu Airfield	JP
RJOH	Yonago Kitaro Airport / JASDF Miho Air Base	JP
RJOI	Iwakuni Kintaikyo Airport / Marine Corps Air Station Iwakuni	JP
RJOK	Kochi Ryoma Airport	JP
RJOM	Matsuyama Airport	JP
RJOO	Osaka International Airport	JP
RJOR	Tottori Sand Dunes Conan Airport	JP
RJOS	Tokushima Awaodori Airport / JMSDF Tokushima Air Base	JP
RJOT	Takamatsu Airport	JP
RJOW	Iwami Airport	JP
RJOY	Yao Airport	JP
RJSA	Aomori Airport	JP
RJSC	Yamagata Airport	JP
RJSD	Sado Airport	JP
RJSF	Fukushima Airport	JP
RJSH	JMSDF Hachinohe Air Base / Hachinohe Airport	JP
RJSI	Iwate Hanamaki Airport	JP
RJSK	Akita Airport	JP
RJSM	Misawa Air Base / Misawa Airport	JP
RJSN	Niigata Airport	JP
RJSR	Odate Noshiro Airport	JP
RJSS	Sendai Airport	JP
RJST	JASDF Matsushima Air Base	JP
RJSY	Shonai Airport	JP
RJTA	JMSDF Atsugi Air Base / Naval Air Facility Atsugi	JP
RJTE	JMSDF Tateyama Air Base	JP
RJTF	Chofu Airport	JP
RJTH	Hachijojima Airport	JP
RJTJ	Iruma Air Base	JP
RJTK	JGSDF Kisarazu Airfield	JP
RJTL	JMSDF Shimofusa Air Base	JP
RJTO	Oshima Airport	JP
RJTQ	Miyakejima Airport	JP
RJTT	Tokyo Haneda International Airport	JP
RJTU	Utsunomiya Airport	JP
RJTY	Yokota Air Base	JP
RKJB	Muan International Airport	KR
RKJJ	Gwangju Airport	KR
RKJK	Kunsan Air Base	KR
RKJY	Yeosu Airport	KR
RKNN	Gangneung Airport (K-18)	KR
RKNW	Wonju Airport / Hoengseong Air Base (K-38/K-46)	KR
RKNY	Yangyang International Airport	KR
RKPC	Jeju International Airport	KR
RKPD	Jeongseok Airport	KR
RKPK	Gimhae International Airport	KR
RKPS	Sacheon Airport / Sacheon Air Base	KR
RKPU	Ulsan Airport	KR
RKSG	Camp Humphreys (A-511) Desiderio Army Airfield	KR
RKSI	Incheon International Airport	KR
RKSM	Seoul Air Base (K-16)	KR
RKSO	Osan Air Base	KR
RKSS	Gimpo International Airport	KR
RKSW	Suwon Airport	KR
RKTH	Pohang Airport (G-815/K-3)	KR
RKTI	Jungwon Air Base/Chungju Airport	KR
RKTN	Daegu Airport	KR
RKTU	Cheongju International Airport/Cheongju Air Base (K-59/G-513)	KR
RKTY	Yecheon Airbase	KR
ROAH	Naha Airport / JASDF Naha Air Base	JP
RODN	Kadena Air Base	JP
ROKJ	Kumejima Airport	JP
ROMD	Minamidaito Airport	JP
ROMY	Miyako Airport	JP
RORE	Iejima Airport	JP
RORK	Kitadaito Airport	JP
RORS	Miyako Shimojishima Airport	JP
RORT	Tarama Airport	JP
RORY	Yoron Airport	JP
ROTM	Futenma Marine Corps Air Station	JP
ROYN	Yonaguni Airport	JP
RPLB	Subic Bay International Airport / Naval Air Station Cubi Point	PH
RPLC	Clark International Airport / Clark Air Base	PH
RPLI	Laoag International Airport	PH
RPLL	Ninoy Aquino International Airport	PH
RPLS	Danilo Atienza Air Base	PH
RPLT	Itbayat Jorge Abad Airport	PH
RPLU	Lubang Airport	PH
RPMA	Allah Valley Airport	PH
RPMB	Rajah Buayan Air Base	PH
RPMC	Cotabato (Awang) Airport	PH
RPMD	Francisco Bangoy International Airport	PH
RPME	Bancasi Airport	PH
RPMF	Bislig Airport	PH
RPMG	Dipolog Airport	PH
RPMH	Camiguin Airport	PH
RPMJ	Jolo Airport	PH
RPMN	Sanga Sanga Airport	PH
RPMO	Labo Airport	PH
RPMP	Pagadian Airport	PH
RPMQ	Mati National Airport	PH
RPMR	General Santos International Airport	PH
RPMS	Surigao Airport	PH
RPMW	Tandag Airport	PH
RPMZ	Zamboanga International Airport	PH
RPSP	Bohol-Panglao International Airport	PH
RPUB	Loakan Airport	PH
RPUD	Daet Airport	PH
RPUH	San Jose Airport	PH
RPUM	Mamburao Airport	PH
RPUN	Naga Airport	PH
RPUO	Basco Airport	PH
RPUR	Dr Juan C Angara Airport	PH
RPUS	San Fernando Airport	PH
RPUT	Tuguegarao Airport	PH
RPUV	Virac Airport	PH
RPUW	Marinduque Airport	PH
RPUY	Cauayan Airport	PH
RPVA	Daniel Z. Romualdez Airport	PH
RPVB	Bacolod-Silay Airport	PH
RPVC	Calbayog Airport	PH
RPVD	Sibulan Airport	PH
RPVE	Godofredo P. Ramos Airport	PH
RPVF	Catarman National Airport	PH
RPVI	Iloilo International Airport	PH
RPVJ	Moises R. Espinosa Airport	PH
RPVK	Kalibo International Airport	PH
RPVM	Mactan Cebu International Airport	PH
RPVO	Ormoc Airport	PH
RPVP	Puerto Princesa International Airport / PAF Antonio Bautista Air Base	PH
RPVR	Roxas Airport	PH
RPVS	Evelio Javier Airport	PH
RPVU	Tugdan Airport	PH
RPVV	Francisco B. Reyes (Busuanga) Airport	PH
RU-0001	Levashovo Air Base	RU
RU-0008	Bada Air Base	RU
RU-0010	Balashov Air Base	RU
RU-0014	Borisoglebsk Air Base	RU
RU-0015	Khotilovo Air Base	RU
RU-0016	Lipetsk Air Base	RU
RU-0018	Buturlinovka Air Base	RU
RU-0023	Chindant Air Base	RU
RU-0028	Kaliningrad Chkalovsk Naval Air Base	RU
RU-0035	Grozny Airport	RU
RU-0036	Irkutsk Northwest Airport	RU
RU-0043	Mius Airport	RU
RU-0050	Yamburg Airport	RU
RU-0060	Chernyakhovsk Naval Air Base	RU
RU-0064	Ostrov Naval Air Base	RU
RU-0065	Pribylovo Naval Air Base	RU
RU-0089	Krymsk Air Base	RU
RU-0090	Krasnodar Central Air Base	RU
RU-0098	Oktyabrskiy Air Base	RU
RU-0125	Bobrovka Air Base	RU
RU-0128	Budyonnovsk Air Base	RU
RU-0132	Chernigovka Air Base	RU
RU-0152	Mozdok Air Base	RU
RU-0189	Kostomuksha Airport	RU
RU-0211	Taganrog Tsentralny Air Base	RU
RU-0217	Sormovo Airfield	RU
RU-0240	Seshcha Air Base	RU
RU-0282	Millerovo Air Base	RU
RU-0303	Privolzhskiy Air Base	RU
RU-0304	Kapustin Yar Airfield	RU
RU-0327	Vozdvizhenka Air Base	RU
RU-0372	Rostov-on-Don Central Air Base	RU
RU-0380	Akhtubinsk Air Base	RU
RU-0764	Kubinka Air Base	RU
RU-1071	Kamensk-Uralskiy Air Base	RU
RU-1892	Dolinsk-Sokol Air Base	RU
RU-2344	Samara Kryazh Air Base	RU
RU-2844	Dzhida Air Base	RU
RU-3686	Oreshkovo	RU
RU-3709	Bagay-Baranovka Air Base	RU
RU-3880	Kansk Air Base	RU
RU-4339	Tambov Air Base	RU
RU-4421	Danilovo Air Base	RU
RU-4464	Olenya Air Base	RU
RU-4536	Rogachyovo Air Base	RU
RU-4609	Shatalovo Air Base	RU
RU-4827	Cheryomushki Air Base	RU
RU-5105	Chuguyevka Air Base	RU
RU-5376	Smuravyovo Air Base	RU
RU-5672	Ivanovo North Air Base	RU
RU-6558	Lyambir Air Base	RU
RU-6560	Ulan-Ude East Airport	RU
RU-6687	Michurinsk Air Base	RU
RU-7576	Step Air Base	RU
RU-7978	Uprun Air Base	RU
RU-8363	Voronezh Baltimor Air Base	RU
RU-8499	Sharomy Air Base	RU
RU-8602	Engels Air Base	RU
RU-8709	Dorokhovo Air Base	RU
RU-9129	Vorkuta Sovetskiy Air Base	RU
RU-9345	Krechevitsy Air Base	RU
RU-9937	Rzhev Air Base	RU
RU-9942	Shaykovka Air Base	RU
SAAC	Comodoro Pierrestegui Airport	AR
SAAG	Gualeguaychu Airport	AR
SAAP	General Urquiza Airport	AR
SAAR	Rosario Islas Malvinas International Airport	AR
SAAV	Sauce Viejo Airport	AR
SABE	Jorge Newbery Airpark	AR
SACO	Ingeniero Ambrosio Taravella Airport	AR
SADF	San Fernando Airport	AR
SADL	La Plata Airport	AR
SADP	El Palomar Airport	AR
SAEZ	Minister Pistarini International Airport	AR
SAHS	Rincon De Los Sauces Airport	AR
SAHZ	Zapala Airport	AR
SAME	El Plumerillo Airport	AR
SAMM	Comodoro D.R. Salomón Airport	AR
SAMR	Suboficial Ay Santiago Germano Airport	AR
SANC	Catamarca Airport	AR
SANE	Vicecomodoro Angel D. La Paz Aragonés Airport	AR
SANL	Capitan V A Almonacid Airport	AR
SANR	Termas de Río Hondo international Airport	AR
SANT	Teniente Benjamin Matienzo Airport	AR
SANU	Domingo Faustino Sarmiento Airport	AR
SAOC	Area De Material Airport	AR
SAOD	Villa Dolores Airport	AR
SAOR	Villa Reynolds Airport	AR
SAOU	Brigadier Mayor D Cesar Raul Ojeda Airport	AR
SAOV	Presidente Néstor Kirchner Regional Airport	AR
SARC	Corrientes Airport	AR
SARE	Resistencia International Airport	AR
SARF	Formosa Airport	AR
SARI	Cataratas Del Iguazú International Airport	AR
SARL	Paso De Los Libres Airport	AR
SARM	Monte Caseros Airport	AR
SARP	Libertador Gral D Jose De San Martin Airport	AR
SASA	Martin Miguel De Guemes International Airport	AR
SASJ	Gobernador Horacio Guzman International Airport	AR
SASO	Orán Airport	AR
SAST	General Enrique Mosconi Airport	AR
SATG	Goya Airport	AR
SATR	Reconquista Airport	AR
SATU	Curuzu Cuatia Airport	AR
SAVB	El Bolson Airport	AR
SAVC	General E. Mosconi Airport	AR
SAVE	Brigadier Antonio Parodi Airport	AR
SAVH	Las Heras Airport	AR
SAVT	Almirante Marco Andres Zar Airport	AR
SAVV	Gobernador Castello Airport	AR
SAVY	El Tehuelche Airport	AR
SAWC	El Calafate - Commander Armando Tola International Airport	AR
SAWD	Puerto Deseado Airport	AR
SAWE	Gobernador Ramón Trejo Noel International Airport	AR
SAWG	Piloto Civil N. Fernández Airport	AR
SAWH	Malvinas Argentinas Airport	AR
SAWJ	Capitan D Daniel Vazquez Airport	AR
SAWP	Perito Moreno Airport	AR
SAWU	Santa Cruz Airport	AR
SAZB	Comandante Espora Airport	AR
SAZG	General Pico Airport	AR
SAZH	Tres Arroyos Airport	AR
SAZL	Santa Teresita Airport	AR
SAZM	Ástor Piazzola International Airport	AR
SAZN	Presidente Peron Airport	AR
SAZO	Necochea Airport	AR
SAZP	Comodoro Pedro Zanni Airport	AR
SAZR	Santa Rosa Airport	AR
SAZS	San Carlos De Bariloche Airport	AR
SAZT	Héroes De Malvinas Airport	AR
SAZV	Villa Gesell Airport	AR
SAZW	Cutral-Co Airport	AR
SAZY	Aviador C. Campos Airport	AR
SBAA	Conceição do Araguaia Airport	BR
SBAC	Aracati Dragão do Mar Regional Airport	BR
SBAF	Campo Délio Jardim de Mattos Airport	BR
SBAN	Base Aérea Airport	BR
SBAQ	Araraquara Airport	BR
SBAR	Aracaju - Santa Maria International Airport	BR
SBAT	Piloto Osvaldo Marques Dias Airport	BR
SBAU	Araçatuba Airport	BR
SBBE	Val de Cans/Júlio Cezar Ribeiro International Airport	BR
SBBG	Comandante Gustavo Kraemer Airport	BR
SBBH	Pampulha - Carlos Drummond de Andrade Airport	BR
SBBI	Bacacheri Airport	BR
SBBQ	Major Brigadeiro Doorgal Borges Airport	BR
SBBR	Presidente Juscelino Kubitschek International Airport	BR
SBBT	Chafei Amsei Airport	BR
SBBV	Atlas Brasil Cantanhede Airport	BR
SBBW	Barra do Garças Airport	BR
SBBZ	Umberto Modiano Airport	BR
SBCA	Coronel Adalberto Mendes da Silva Airport	BR
SBCC	Campo de Provas Brigadeiro Veloso	BR
SBCF	Tancredo Neves International Airport	BR
SBCG	Campo Grande Airport	BR
SBCH	Serafin Enoss Bertaso Airport	BR
SBCI	Brig. Lysias Augusto Rodrigues Airport	BR
SBCJ	Carajás Airport	BR
SBCM	Forquilhinha - Criciúma  Airport	BR
SBCO	Canoas Air Force Base	BR
SBCP	Bartolomeu Lisandro Airport	BR
SBCR	Corumbá International Airport	BR
SBCT	Afonso Pena Airport	BR
SBCV	Caravelas Airport	BR
SBCX	Hugo Cantergiani Regional Airport	BR
SBCY	Marechal Rondon Airport	BR
SBCZ	Cruzeiro do Sul Airport	BR
SBDN	Presidente Prudente Airport	BR
SBEG	Eduardo Gomes International Airport	BR
SBEK	Jacareacanga Airport	BR
SBFI	Cataratas International Airport	BR
SBFL	Hercílio Luz International Airport	BR
SBFN	Fernando de Noronha Airport	BR
SBFZ	Pinto Martins International Airport	BR
SBGL	Rio Galeão – Tom Jobim International Airport	BR
SBGM	Guajará-Mirim Airport	BR
SBGO	Santa Genoveva Airport	BR
SBGR	Guarulhos - Governador André Franco Montoro International Airport	BR
SBGW	Guaratinguetá Airport	BR
SBHT	Altamira Interstate Airport	BR
SBIC	Itacoatiara Airport	BR
SBIH	Itaituba Airport	BR
SBIL	Bahia - Jorge Amado Airport	BR
SBIP	Vale do Aço Regional Airport	BR
SBIZ	Prefeito Renato Moreira Airport	BR
SBJF	Francisco de Assis Airport	BR
SBJH	São Paulo Catarina Executive Airport	BR
SBJP	Presidente Castro Pinto International Airport	BR
SBJV	Lauro Carneiro de Loyola Airport	BR
SBKG	Presidente João Suassuna Airport	BR
SBKP	Viracopos International Airport	BR
SBLJ	Lages Airport	BR
SBLN	Lins Airport	BR
SBLO	Governador José Richa Airport	BR
SBLP	Bom Jesus da Lapa Airport	BR
SBMA	João Correa da Rocha Airport	BR
SBMC	Minaçu Airport	BR
SBMD	Monte Dourado - Serra do Areão Airport	BR
SBME	Macaé Benedito Lacerda Airport	BR
SBMG	Regional de Maringá - Sílvio Name Júnior Airport	BR
SBMK	Mário Ribeiro Airport	BR
SBML	Frank Miloye Milenkowichi–Marília State Airport	BR
SBMN	Ponta Pelada Airport / Manaus Air Base	BR
SBMO	Zumbi dos Palmares Airport	BR
SBMQ	Macapá - Alberto Alcolumbre International Airport	BR
SBMS	Dix-Sept Rosado Airport	BR
SBMT	Campo de Marte Airport	BR
SBMY	Manicoré Airport	BR
SBNF	Ministro Victor Konder International Airport	BR
SBNM	Santo Ângelo Airport	BR
SBNT	Natal Air Force Base	BR
SBOI	Oiapoque Airport	BR
SBPA	Salgado Filho International Airport	BR
SBPB	Parnaíba - Prefeito Doutor João Silva Filho International Airport	BR
SBPC	Poços de Caldas - Embaixador Walther Moreira Salles Airport	BR
SBPF	Lauro Kurtz Airport	BR
SBPJ	Brigadeiro Lysias Rodrigues Airport	BR
SBPK	João Simões Lopes Neto International Airport	BR
SBPL	Senador Nilo Coelho Airport	BR
SBPN	Porto Nacional Airport	BR
SBPP	Ponta Porã Airport	BR
SBPS	Porto Seguro Airport	BR
SBPV	Governador Jorge Teixeira de Oliveira Airport	BR
SBRB	Rio Branco-Plácido de Castro International Airport	BR
SBRF	Recife/Guararapes - Gilberto Freyre International Airport	BR
SBRJ	Santos Dumont Airport	BR
SBRP	Leite Lopes Airport	BR
SBSC	Santa Cruz Air Force Base	BR
SBSG	São Gonçalo do Amarante - Governador Aluízio Alves International Airport	BR
SBSJ	Professor Urbano Ernesto Stumpf Airport	BR
SBSL	Marechal Cunha Machado International Airport	BR
SBSM	Santa Maria Airport	BR
SBSN	Santarém - Maestro Wilson Fonseca International Airport	BR
SBSP	Congonhas Airport	BR
SBSR	Prof. Eribelto Manoel Reino State Airport	BR
SBST	Santos Nero Moura Air Base / Guarujá Airport	BR
SBSV	Deputado Luiz Eduardo Magalhães International Airport	BR
SBTA	Base de Aviação de Taubaté	BR
SBTB	Trombetas Airport	BR
SBTE	Senador Petrônio Portela Airport	BR
SBTF	Tefé Airport	BR
SBTK	Tarauacá Airport	BR
SBTL	Telêmaco Borba Airport	BR
SBTS	Tiriós Airport	BR
SBTT	Tabatinga Airport	BR
SBTU	Tucuruí Airport	BR
SBUA	São Gabriel da Cachoeira Airport	BR
SBUF	Paulo Afonso Airport	BR
SBUG	Rubem Berta Airport	BR
SBUL	Ten. Cel. Aviador César Bombonato Airport	BR
SBUR	Mário de Almeida Franco Airport	BR
SBVG	Major Brigadeiro Trompowsky Airport	BR
SBVH	Brigadeiro Camarão Airport	BR
SBVT	Eurico de Aguiar Salles Airport	BR
SBYS	Campo Fontenelle	BR
SBZM	Presidente Itamar Franco Airport	BR
SCAR	Chacalluta Airport	CL
SCAT	Desierto de Atacama Airport	CL
SCBA	Balmaceda Airport	CL
SCBE	Barriles Airport	CL
SCCC	Chile Chico Airport	CL
SCCF	El Loa Airport	CL
SCCH	Gral. Bernardo O´Higgins Airport	CL
SCCI	President Carlos Ibañez del Campo International Airport	CL
SCCY	Teniente Vidal Airport	CL
SCDA	Diego Aracena Airport	CL
SCEL	Comodoro Arturo Merino Benítez International Airport	CL
SCES	Ricardo García Posada Airport	CL
SCFA	Andrés Sabella Gálvez International Airport	CL
SCFM	Captain Fuentes Martinez Airport	CL
SCGZ	Guardiamarina Zañartu Airport	CL
SCHR	Cochrane Airport	CL
SCIE	Carriel Sur Airport	CL
SCIP	Mataveri Airport	CL
SCJO	Cañal Bajo Carlos - Hott Siebert Airport	CL
SCLL	Vallenar Airport	CL
SCNT	Lieutenant Julio Gallardo Airport	CL
SCQP	La Araucanía Airport	CL
SCRA	Chañaral Airport	CL
SCRG	La Independencia Airport	CL
SCSE	La Florida Airport	CL
SCTC	Maquehue Airport	CL
SCTE	El Tepual Airport	CL
SCTL	Panguilemo Airport	CL
SCTO	Victoria Airport	CL
SCTT	Las Breas Airport	CL
SCVD	Pichoy Airport	CL
SCVM	Viña del mar Airport	CL
SD-0001	Wadi Seidna Air Base	SD
SEAM	Chachoán Regional Airport	EC
SECO	Francisco De Orellana Airport	EC
SECU	Mariscal Lamar Airport	EC
SEGU	José Joaquín de Olmedo International Airport	EC
SELT	Cotopaxi International Airport	EC
SEMA	Jose Maria Velasco Ibarra Airport	EC
SEMC	Coronel E Carvajal Airport	EC
SEMT	Eloy Alfaro International Airport	EC
SEPV	Reales Tamarindos Airport	EC
SEQM	Mariscal Sucre International Airport	EC
SERO	Santa Rosa - Artillery Colonel Victor Larrea International Airport	EC
SESA	General Ulpiano Paez Airport	EC
SETR	Tarapoa Airport	EC
SETU	Lieutenant Colonel Luis A. Mantilla International Airport	EC
SFAL	Port Stanley Airport	FK
SGAS	Aeropuerto Internacional Silvio Pettirossi	PY
SGAY	Aeropuerto Nacional de Juan De Ayolas	PY
SGCO	Aeropuerto Nacional Tte. Cnel. Carmelo Peralta	PY
SGES	Aeropuerto Internacional Guaraní	PY
SGGR	Aeropuerto Nacional de Salto del Guaira	PY
SGIB	Aeropuerto Nacional de Itaipú	PY
SGME	Aeropuerto Internacional Dr. Luis Maria Argaña	PY
SGPI	Aeropuerto Nacional Carlos Miguel Gimenez	PY
SGPJ	Aeropuerto Internacional Dr. Augusto Roberto Fuster	PY
SJTC	Bauru/Arealva–Moussa Nakhal Tobias State Airport	BR
SKAP	Gomez Nino Apiay Air Base	CO
SKAR	El Eden Airport	CO
SKAS	Tres De Mayo Airport	CO
SKBC	Las Flores Airport	CO
SKBG	Palonegro Airport	CO
SKBO	El Dorado International Airport	CO
SKBQ	Ernesto Cortissoz International Airport	CO
SKBS	José Celestino Mutis Airport	CO
SKBU	Gerardo Tobar López Airport	CO
SKCC	Camilo Daza International Airport	CO
SKCG	Rafael Nuñez International Airport	CO
SKCL	Alfonso Bonilla Aragon International Airport	CO
SKCO	La Florida Airport	CO
SKCU	Juan H White Airport	CO
SKCV	Coveñas Airport	CO
SKCZ	Las Brujas Airport	CO
SKEB	El Bagre Airport	CO
SKEJ	Yariguíes Airport	CO
SKFL	Gustavo Artunduaga Paredes Airport	CO
SKGI	Santiago Vila Airport	CO
SKGO	Santa Ana Airport	CO
SKGP	Juan Casiano Airport	CO
SKIB	Perales Airport	CO
SKIP	San Luis Airport	CO
SKLC	Antonio Roldán Betancur Airport	CO
SKLM	Jorge Isaac Airport	CO
SKLT	Alfredo Vásquez Cobo International Airport	CO
SKMD	Enrique Olaya Herrera Airport	CO
SKMG	Baracoa Airport	CO
SKMR	Los Garzones Airport	CO
SKMU	Fabio Alberto Leon Bentley Airport	CO
SKMZ	La Nubia Airport	CO
SKNV	Benito Salas Airport	CO
SKOC	Aguas Claras Airport	CO
SKPC	German Olano Airport	CO
SKPD	Obando Cesar Gaviria Trujillo Airport	CO
SKPE	Matecaña International Airport	CO
SKPI	Pitalito Airport	CO
SKPP	Guillermo León Valencia Airport	CO
SKPQ	German Olano Air Base	CO
SKPS	Antonio Nariño Airport	CO
SKPV	El Embrujo Airport	CO
SKPZ	Paz De Ariporo Airport	CO
SKQU	Mariquita Airport	CO
SKRG	Jose Maria Córdova International Airport	CO
SKRH	Almirante Padilla Airport	CO
SKSJ	Jorge E. Gonzalez Torres Airport	CO
SKSM	Simón Bolívar International Airport	CO
SKSP	Gustavo Rojas Pinilla International Airport	CO
SKSV	Eduardo Falla Solano Airport	CO
SKTJ	Tunja Airport	CO
SKTM	Gustavo Vargas Airport	CO
SKTQ	Tres Esquinas Air Base	CO
SKUA	Marandúa Air Base	CO
SKUC	Santiago Perez Airport	CO
SKUI	El Caraño Airport	CO
SKUL	Heriberto Gíl Martínez Airport	CO
SKVP	Alfonso López Pumarejo Airport	CO
SKVV	Vanguardia Airport	CO
SKYP	El Yopal Airport	CO
SLAL	Alcantarí Airport	BO
SLBJ	Bermejo Airport	BO
SLCB	Jorge Wilsterman International Airport	BO
SLCO	Capitán Aníbal Arab Airport	BO
SLET	El Trompillo Airport	BO
SLLP	El Alto International Airport	BO
SLOR	Juan Mendoza Airport	BO
SLPO	Capitan Nicolas Rojas Airport	BO
SLPS	Capitán Av. Salvador Ogaya G. airport	BO
SLSA	Santa Ana Del Yacuma Airport	BO
SLSU	Juana Azurduy De Padilla Airport	BO
SLSV	San Ignacio de Velasco Airport	BO
SLTJ	Capitan Oriel Lea Plaza Airport	BO
SLTR	Teniente Av. Jorge Henrich Arauz Airport	BO
SLVM	Teniente Coronel Rafael Pabón Airport	BO
SLVR	Viru Viru International Airport	BO
SLYA	Yacuiba Airport	BO
SMJP	Johan Adolf Pengel International Airport	SR
SN6L	Dr. Luciano de Arruda Coelho Regional Airport	BR
SNCP	Planalto Serrano Regional Airport	BR
SNRS	Russas - João De Deus Regional Airport	BR
SO-0001	K50 International Airport	SO
SOCA	Cayenne – Félix Eboué Airport	GF
SOOG	Saint-Georges-de-l'Oyapock Airport	GF
SPAY	Teniente General Gerardo Pérez Pinedo Airport	PE
SPBC	Caballococha Airport	PE
SPBR	Iberia Airport	PE
SPCL	Cap FAP David Abenzur Rengifo International Airport	PE
SPEO	FAP Lieutenant Jaime Andres de Montreuil Morales Airport	PE
SPHI	Air Force Captain Jose A Quinones Gonzales International Airport	PE
SPHO	Air Force Colonel Alfredo Mendivil Duarte Airport	PE
SPHZ	Comandante FAP German Arias Graziani Airport	PE
SPIM	Jorge Chávez International Airport	PE
SPJA	Juan Simons Vela Airport	PE
SPJE	Shumba Airport	PE
SPJI	Juanjui Airport	PE
SPJJ	Francisco Carle Airport	PE
SPJL	Inca Manco Capac International Airport	PE
SPJR	Mayor General FAP Armando Revoredo Iglesias Airport	PE
SPLO	General Jorge Fernandez Maldon Airport	PE
SPME	Captain Pedro Canga Rodríguez International Airport	PE
SPMS	Moises Benzaquen Rengifo Airport	PE
SPNC	Alferez Fap David Figueroa Fernandini Airport	PE
SPPY	Chachapoyas Airport	PE
SPQT	Coronel FAP Francisco Secada Vignetta International Airport	PE
SPQU	Rodríguez Ballón International Airport	PE
SPRU	Capitan FAP Carlos Martinez De Pinillos International Airport	PE
SPSO	Captain Renán Elías Olivera International Airport	PE
SPST	Cadete FAP Guillermo Del Castillo Paredes Airport	PE
SPTN	Coronel FAP Carlos Ciriani Santa Rosa International Airport	PE
SPTU	Padre Aldamiz International Airport	PE
SPUR	Capitán FAP Guillermo Concha Iberico International Airport	PE
SPYL	Captain Victor Montes Arias International Airport	PE
SPZA	Maria Reiche Neuman Airport	PE
SPZO	Alejandro Velasco Astete International Airport	PE
SQD	Shangrao Sanqingshan Airport	CN
SQJ	Sanming Shaxian Airport	CN
SSZW	Ponta Grossa Airport - Comandante Antonio Amilton Beraldo	BR
SUAA	Ángel S. Adami International Airport	UY
SUDU	Santa Bernardina International Airport	UY
SULS	Capitan Corbeta CA Curbelo International Airport	UY
SUMU	Carrasco General Cesáreo L. Berisso International Airport	UY
SUSO	Nueva Hesperides International Airport	UY
SVAC	Oswaldo Guevara Mujica Airport	VE
SVAN	Anaco Airport	VE
SVBC	General José Antonio Anzoategui International Airport	VE
SVBI	Barinas Airport	VE
SVBL	El Libertador Airbase	VE
SVBM	Barquisimeto International Airport	VE
SVBS	Escuela Mariscal Sucre Airport	VE
SVCB	Aeropuerto "General Tomas de Heres". Ciudad Bolivar	VE
SVCD	Caicara del Orinoco Airport	VE
SVCL	Calabozo Airport	VE
SVCN	Canaima Airport	VE
SVCP	General Francisco Bermúdez Airport	VE
SVCR	José Leonardo Chirinos Airport	VE
SVCS	Oscar Machado Zuluaga Airport	VE
SVCU	Cumaná (Antonio José de Sucre) Airport	VE
SVED	El Dorado Airport	VE
SVEZ	Elorza Airport	VE
SVFM	Generalissimo Francisco de Miranda Air Base	VE
SVGD	Guasdalito Airport	VE
SVGI	Guiria Airport	VE
SVGU	Guanare Airport	VE
SVJC	Josefa Camejo International Airport	VE
SVJM	San Juan de Los Morros Airport	VE
SVLF	La Fria Airport	VE
SVMC	La Chinita International Airport	VE
SVMD	Alberto Carnevalli Airport	VE
SVMG	Del Caribe Santiago Mariño International Airport	VE
SVMI	Simón Bolívar International Airport	VE
SVMP	Metropolitano Airport	VE
SVMT	Maturín Airport	VE
SVPA	Cacique Aramare Airport	VE
SVPC	General Bartolome Salom International Airport	VE
SVPM	Paramillo Airport	VE
SVPR	General Manuel Carlos Piar International Airport	VE
SVPT	Palmarito Airport	VE
SVSA	San Antonio Del Tachira Airport	VE
SVSE	Santa Elena de Uairen Airport	VE
SVSO	Mayor Buenaventura Vivas International Airport	VE
SVSP	Sub Teniente Nestor Arias Airport	VE
SVSR	San Fernando De Apure Airport	VE
SVST	San Tomé Airport	VE
SVSZ	Santa Bárbara del Zulia Airport	VE
SVTC	Tucupita Airport	VE
SVTM	Tumeremo Airport	VE
SVVA	Arturo Michelena International Airport	VE
SVVG	Juan Pablo Pérez Alfonso Airport	VE
SVVL	Dr. Antonio Nicolás Briceño Airport	VE
SVVP	Valle de La Pascua Airport	VE
SWGN	Araguaína Airport	BR
SWRD	Maestro Marinho Franco Airport	BR
SYCJ	Cheddi Jagan International Airport	GY
SYGO	Eugene F. Correira International Airport	GY
SYLT	Lethem Airport	GY
TAO	Qingdao Jiaodong International Airport	CN
TAPA	V C Bird International Airport	AG
TAPH	Codrington Airport	AG
TBPB	Grantley Adams International Airport	BB
TDCF	Canefield Airport	DM
TDPD	Douglas-Charles Airport	DM
TFFF	Martinique Aimé Césaire International Airport	MQ
TFFG	Grand Case-Espérance Airport	MF
TFFJ	Saint Barthélemy - Rémy de Haenen Airport	BL
TFFM	Les Bases Airport	GP
TFFR	Pointe-à-Pitre Le Raizet International  Airport	GP
TGPY	Maurice Bishop International Airport	GD
TIST	Cyril E. King Airport	VI
TISX	Henry E Rohlsen Airport	VI
TJ-UT45	Gissar Air Base	TJ
TJ-UT46	Farkhor Air Base	TJ
TJAB	Antonio Nery Juarbe Pol Airport	PR
TJBQ	Rafael Hernández International Airport	PR
TJIG	Fernando Luis Ribas Dominicci Airport	PR
TJMZ	Eugenio Maria De Hostos Airport	PR
TJPS	Mercedita Airport	PR
TJSJ	Luis Munoz Marin International Airport	PR
TKPK	Robert L. Bradshaw International Airport	KN
TKPN	Vance W. Amory International Airport	KN
TLPC	George F. L. Charles Airport	LC
TLPL	Hewanorra International Airport	LC
TM-UT52	Mary North Airport	TM
TNCA	Queen Beatrix International Airport	AW
TNCB	Flamingo International Airport	BQ
TNCC	Hato International Airport	CW
TNCE	F. D. Roosevelt Airport	BQ
TNCM	Princess Juliana International Airport	SX
TNW	Jumandy Airport	EC
TQPF	Clayton J Lloyd International Airport	AI
TR-0004	Temelli Air Base	TR
TR-0021	Çukurhisar Airport	TR
TR-0028	Keşan Air Base	TR
TRPG	John A. Osborne Airport	MS
TTCP	Tobago-Crown Point Airport	TT
TTPP	Piarco International Airport	TT
TUPJ	Terrance B. Lettsome International Airport	VG
TVSA	Argyle International Airport	VC
TVSB	J F Mitchell Airport	VC
TVSC	Canouan Airport	VC
TVSM	Mustique Airport	VC
TVSU	Union Island International Airport	VC
TW-0004	Zuoying Naval Airfield	TW
TXKF	L.F. Wade International International Airport	BM
UA-0005	Nizhyn Air Base	UA
UA-0010	Oktyabrskoe Air Base	UA
UA-0012	Kirovskoe Air Base	UA
UA-0020	Melitopol Air Base	UA
UA-0022	Kacha Air Base	UA
UA-0025	Bila Tserkva Air Base	UA
UA-0028	Zhovtneve Air Base	UA
UA30	Batken Airport	KG
UAAA	Almaty International Airport	KZ
UAAH	Balkhash Airport	KZ
UAAT	Taldykorgan Airport	KZ
UACC	Nursultan Nazarbayev International Airport	KZ
UACK	Kokshetau Airport	KZ
UACP	Petropavl Airport	KZ
UADD	Taraz Airport	KZ
UAFL	Issyk-Kul International Airport	KG
UAFM	Manas International Airport	KG
UAFO	Osh Airport	KG
UAFW	Kant Air Base	KG
UAII	Shymkent Airport	KZ
UAIT	Hazrat Sultan International Airport	KZ
UAKD	Zhezkazgan National Airport	KZ
UAKK	Sary-Arka Airport	KZ
UAON	Yubileyniy Airfield	KZ
UARR	Uralsk Airport	KZ
UASA	Ayaguz Airport	KZ
UASB	Ekibastuz Airport	KZ
UASK	Ust-Kamenogorsk Airport	KZ
UASP	Pavlodar Airport	KZ
UASS	Semey Airport	KZ
UATE	Aktau Airport	KZ
UATG	Atyrau International Airport	KZ
UATR	Shalkar Airport	KZ
UATT	Aktobe Airport	KZ
UAUU	Kostanay West Airport	KZ
UB12	Nasosnaya Air Base	AZ
UB13	Stepanakert Airport	AZ
UB14	Kyurdamir Air Base	AZ
UB18	Baku Kala Air Base	AZ
UBBB	Heydar Aliyev International Airport	AZ
UBBG	Ganja International Airport	AZ
UBBN	Nakhchivan Airport	AZ
UBBQ	Gabala International Airport	AZ
UBBY	Zaqatala International Airport	AZ
UDSG	Shirak International Airport	AM
UDYE	Erebuni Airport	AM
UDYZ	Zvartnots International Airport	AM
UEEE	Yakutsk Airport	RU
UELL	Chulman Airport	RU
UEMA	Moma Airport	RU
UEMM	Magan Airport	RU
UEMO	Olyokminsk Airport	RU
UEMT	Ust-Nera Airport	RU
UENK	Kyzyl-Syr Airport	RU
UENW	Vilyuisk Airport	RU
UERA	Aykhal Airport	RU
UERL	Lensk Airport	RU
UERP	Polyarny Airport	RU
UERR	Mirny Airport	RU
UERS	Saskylakh Airport	RU
UESG	Belaya Gora Airport	RU
UESK	Srednekolymsk Airport	RU
UESO	Chokurdakh Airport	RU
UESS	Cherskiy Airport	RU
UEST	Tiksi Airport	RU
UESU	Zyryanka Airport	RU
UG0U	Gudauta Air Base	GE
UG11	Dollyar Air Base	AZ
UG22	Tbilisi Marneuli Air Base	GE
UG24	Tbilisi Soganlug Air Base	GE
UG27	Vaziani Air Base	GE
UG28	Bolshiye Shiraki Air Base	GE
UGAM	Ambrolauri Airport	GE
UGKO	David the Builder Kutaisi International Airport	GE
UGSB	Batumi International Airport	GE
UGSS	Sukhumi Babushara /  Vladislav Ardzinba International Airport	GE
UGTB	Tbilisi International Airport	GE
UHBB	Ignatyevo Airport	RU
UHHH	Khabarovsk Novy Airport	RU
UHKD	Dzemgi Airport	RU
UHKG	Kamenny Ruchey Naval Air Base	RU
UHKK	Komsomolsk-on-Amur Airport	RU
UHKM	Sovetskaya Gavan (Maygatka) Airport	RU
UHMA	Ugolny Yuri Ryktheu Airport	RU
UHMD	Provideniya Bay Airport	RU
UHMF	Omsukchan Airport	RU
UHMG	Chaybukha Airport	RU
UHMK	Keperveem Airport	RU
UHMM	Sokol Airport	RU
UHMP	Pevek Airport	RU
UHMS	Seymchan Airport	RU
UHMT	Magadan-13 Airport	RU
UHMW	Severo-Evensk Airport	RU
UHNN	Nikolayevsk-na-Amure Airport	RU
UHOO	Okhotsk Airport	RU
UHPL	Palana Airport	RU
UHPP	Yelizovo Airport	RU
UHSS	Yuzhno-Sakhalinsk Airport	RU
UHWW	Vladivostok International Airport	RU
UIAA	Chita-Kadala International Airport	RU
UIAE	Krasnokamensk Airport	RU
UIBB	Bratsk Airport	RU
UIBV	Zheleznogorsk Airport	RU
UIII	Irkutsk International Airport	RU
UITT	Ust-Kut Airport	RU
UIUU	Baikal International Airport	RU
UKBB	Boryspil International Airport	UA
UKCM	Mariupol International Airport	UA
UKDD	Dnipro International Airport	UA
UKDE	Zaporizhzhia International Airport	UA
UKDR	Kryvyi Rih International Airport	UA
UKFB	Sevastopol International Airport / Belbek Air Base	UA
UKFF	Simferopol International Airport	UA
UKFG	Gvardeyskoe Air Base	UA
UKFI	Saky Air Base	UA
UKFY	Dzhankoy Airport	UA
UKHH	Kharkiv International Airport	UA
UKKE	Cherkasy International Airport	UA
UKKK	Ihor Sikorsky Kyiv International Airport (Zhuliany)	UA
UKKM	Hostomel Airport	UA
UKKO	Ozerne Air Base	UA
UKLH	Khmelnytskyi Airport	UA
UKLI	Ivano-Frankivsk International Airport	UA
UKLL	Lviv International Airport	UA
UKLN	Chernivtsi International Airport	UA
UKLR	Rivne International Airport	UA
UKLU	Uzhhorod International Airport	UA
UKOH	Kherson International Airport	UA
UKON	Mykolaiv International Airport	UA
UKOO	Odessa International Airport	UA
UKWW	Vinnytsia/Gavyryshivka International Airport	UA
ULAA	Talagi Airport	RU
ULAK	Severomorsk-1 Naval Air Base	RU
ULAM	Naryan Mar Airport	RU
ULBC	Cherepovets Airport	RU
ULDD	Amderma Airport	RU
ULH	Majeed Bin Abdulaziz Airport	SA
ULKK	Kotlas Airport	RU
ULLI	Pulkovo Airport	RU
ULLP	Pushkin Airport	RU
ULMM	Murmansk Airport	RU
ULNR	Staraya Russa Air Base	RU
ULOO	Pskov Airport	RU
ULPB	Petrozavodsk Airport	RU
ULPP	Peski Airport	RU
ULWW	Vologda Airport	RU
UMBB	Brest Airport	BY
UMGG	Gomel Airport	BY
UMII	Vitebsk Vostochny Airport	BY
UMKK	Khrabrovo Airport	RU
UMMA	Baranavichi Air Base	BY
UMMG	Hrodna Airport	BY
UMMS	Minsk National Airport	BY
UMNB	Babruisk Air Base	BY
UMOO	Mogilev Airport	BY
UNAA	Abakan International Airport	RU
UNBB	Barnaul Airport	RU
UNBG	Gorno-Altaysk Airport	RU
UNEE	Kemerovo Airport	RU
UNIB	Baykit Airport	RU
UNII	Yeniseysk Airport	RU
UNIP	Podkamennaya Tunguska Airport	RU
UNIS	Severo-Yeniseysk Airport	RU
UNIW	Vanavara Airport	RU
UNKL	Krasnoyarsk International Airport	RU
UNKM	Krasnoyarsk Cheremshanka Airport	RU
UNKS	Achinsk Airport	RU
UNKY	Kyzyl Airport	RU
UNNE	Yeltsovka Airport	RU
UNNT	Novosibirsk Tolmachevo Airport	RU
UNOO	Omsk Central Airport	RU
UNOS	Omsk Severny Airport	RU
UNSS	Strezhevoy Airport	RU
UNTT	Bogashevo Airport	RU
UNWW	Spichenkovo Airport	RU
UODD	Dikson Airport	RU
UODN	Nagurskoye	RU
UOHH	Khatanga Airport	RU
UOIG	Svetlogorsk Airport	RU
UOII	Igarka Airport	RU
UOOO	Norilsk-Alykel Airport	RU
UOOW	Valek Airport	RU
URKA	Anapa Vityazevo Airport	RU
URKE	Yeysk Airport	RU
URKG	Gelendzhik Airport	RU
URKH	Khanskaya Air Base	RU
URKK	Krasnodar Pashkovsky International Airport	RU
URMG	Khankala Air Base	RU
URML	Makhachkala Uytash International Airport	RU
URMM	Mineralnyye Vody Airport	RU
URMN	Nalchik Airport	RU
URMO	Vladikavkaz Beslan International Airport	RU
URMS	Magas Airport	RU
URMT	Stavropol Shpakovskoye Airport	RU
UROD	Dudinka Airport	RU
URRP	Platov International Airport	RU
URRT	Taganrog Yuzhny Airport	RU
URSS	Sochi International Airport	RU
URWA	Astrakhan Narimanovo Boris M. Kustodiev International Airport	RU
URWI	Elista Airport	RU
URWW	Volgograd International Airport	RU
US-0086	Jim's Private Airport	US
US-0254	Yuma Auxiliary Army Airfield 2	US
US-0571	Williston Basin International Airport	US
USCC	Chelyabinsk Balandino Airport	RU
USCM	Magnitogorsk International Airport	RU
USDA	Sabetta International Airport	RU
USDB	Bovanenkovo Airport	RU
USDD	Salekhard Airport	RU
USHB	Berezovo Airport	RU
USHH	Khanty Mansiysk Airport	RU
USHN	Nyagan Airport	RU
USHS	Sovetskiy Airport	RU
USHU	Uray Airport	RU
USHY	Beloyarskiy Airport	RU
USII	Izhevsk Airport	RU
USKK	Pobedilovo Airport	RU
USMM	Nadym Airport	RU
USMU	Novy Urengoy Airport	RU
USNN	Nizhnevartovsk Airport	RU
USPP	Perm International Airport	RU
USRK	Kogalym International Airport	RU
USRN	Nefteyugansk Airport	RU
USRO	Noyabrsk Airport	RU
USRR	Surgut Airport	RU
USSK	Uktus Airport	RU
USSS	Koltsovo Airport	RU
USTR	Roshchino International Airport	RU
USUU	Kurgan Airport	RU
UT1G	Ashgabat Bezmein Air Base	TM
UTAA	Ashgabat International Airport	TM
UTAK	Turkmenbashi International Airport	TM
UTAM	Mary International Airport	TM
UTAT	Daşoguz Airport	TM
UTAV	Türkmenabat International Airport	TM
UTDD	Dushanbe Airport	TJ
UTDK	Kulob Airport	TJ
UTDL	Khujand Airport	TJ
UTDT	Qurghonteppa International Airport	TJ
UTKA	Andizhan Airport	UZ
UTKF	Fergana International Airport	UZ
UTNN	Nukus Airport	UZ
UTNU	Urgench Airport	UZ
UTSA	Navoi Airport	UZ
UTSB	Bukhara International Airport	UZ
UTSS	Samarkand Airport	UZ
UTST	Termez Airport	UZ
UTTP	Tashkent East Airport	UZ
UTTT	Tashkent International Airport	UZ
UUBA	Kostroma Sokerkino Airport	RU
UUBC	Grabtsevo Airport	RU
UUBD	Dyagilevo Air Base	RU
UUBI	Ivanovo South Airport	RU
UUBK	Staroselye Airport	RU
UUBL	Semyazino Airport	RU
UUBM	Myachkovo Airport	RU
UUBP	Bryansk Airport	RU
UUBW	Zhukovsky International Airport	RU
UUDD	Domodedovo International Airport	RU
UUEE	Sheremetyevo International Airport	RU
UUEM	Migalovo Air Base	RU
UUMO	Ostafyevo International Airport	RU
UUMT	Tretyakovo Airport	RU
UUMU	Chkalovskiy Air Base	RU
UUOB	Belgorod International Airport	RU
UUOK	Kursk East Airport	RU
UUOL	Lipetsk Airport	RU
UUOO	Voronezh International Airport	RU
UUOT	Donskoye Airport	RU
UUWE	Yermolino Air Base	RU
UUWW	Vnukovo International Airport	RU
UUYH	Ukhta Airport	RU
UUYI	Inta Airport	RU
UUYK	Vuktyl Airport	RU
UUYP	Pechora Airport	RU
UUYS	Usinsk Airport	RU
UUYV	Izhma Airport	RU
UUYW	Vorkuta Airport	RU
UUYX	Ust-Tsylma Airport	RU
UUYY	Syktyvkar Airport	RU
UWGG	Nizhny Novgorod Strigino International Airport	RU
UWKB	Bugulma Airport	RU
UWKD	Kazan International Airport	RU
UWKE	Begishevo Airport	RU
UWKG	Borisoglebskoye Airport	RU
UWKJ	Yoshkar-Ola Airport	RU
UWKS	Cheboksary Airport	RU
UWKV	Zhigansk Airport	RU
UWLL	Ulyanovsk Baratayevka Airport	RU
UWLW	Ulyanovsk East Airport	RU
UWOO	Orenburg Central Airport	RU
UWOR	Orsk Airport	RU
UWPP	Penza Airport	RU
UWPS	Saransk Airport	RU
UWSB	Balakovo Airport	RU
UWSG	Gagarin International Airport	RU
UWUU	Ufa International Airport	RU
UWWB	Buguruslan Severny Airport	RU
UWWG	Bezymyanka Airfield	RU
UWWW	Kurumoch International Airport	RU
VA1G	Rewa Airport, Chorhata, REWA	IN
VA2C	Gondia Airport	IN
VAAH	Sardar Vallabh Bhai Patel International Airport	IN
VAAK	Akola Airport	IN
VAAU	Aurangabad Airport	IN
VABB	Chhatrapati Shivaji International Airport	IN
VABI	Bilaspur Airport	IN
VABJ	Bhuj Airport	IN
VABM	Belagavi Airport	IN
VABO	Vadodara Airport	IN
VABP	Raja Bhoj International Airport	IN
VABV	Bhavnagar Airport	IN
VADN	Daman Airport	IN
VAGO	Dabolim Airport	IN
VAHB	Hubli Airport	IN
VAID	Devi Ahilyabai Holkar Airport	IN
VAJB	Jabalpur Airport	IN
VAJM	Jamnagar Airport	IN
VAKE	Kandla Airport	IN
VAKJ	Khajuraho Airport	IN
VAKP	Kolhapur Airport	IN
VAKS	Keshod Airport	IN
VAND	Nanded Airport	IN
VANP	Dr. Babasaheb Ambedkar International Airport	IN
VAOZ	Nashik Airport	IN
VAPO	Pune Airport / Lohagaon Air Force Station	IN
VAPR	Porbandar Airport	IN
VARG	Ratnagiri Airport	IN
VARK	Rajkot Airport	IN
VASD	Shirdi Airport	IN
VASL	Solapur Airport	IN
VASU	Surat Airport	IN
VAUD	Maharana Pratap Airport	IN
VCBI	Bandaranaike International Colombo Airport	LK
VCCA	Anuradhapura Airport	LK
VCCB	Batticaloa Airport	LK
VCCC	Colombo Ratmalana Airport	LK
VCCG	Ampara Airport	LK
VCCH	Hingurakgoda Air Force Base	LK
VCCJ	Jaffna International Airport	LK
VCCK	Koggala Airport	LK
VCCT	China Bay Airport	LK
VCRI	Mattala Rajapaksa International Airport	LK
VDBG	Battambang Airport	KH
VDKH	Kampong Chhnang Airport	KH
VDPP	Phnom Penh International Airport	KH
VDRK	Ratanakiri Airport	KH
VDSR	Siem Reap International Airport	KH
VE44	Hashimara Air Force Station	IN
VE89	Darbhanga Airport	IN
VEAN	Along Airport	IN
VEAT	Agartala - Maharaja Bir Bikram Airport	IN
VEBD	Bagdogra Airport	IN
VEBI	Shillong Airport	IN
VEBS	Biju Patnaik Airport	IN
VECC	Netaji Subhash Chandra Bose International Airport	IN
VEDB	Dhanbad Airport	IN
VEDG	Kazi Nazrul Islam Airport	IN
VEGK	Gorakhpur Airport	IN
VEGT	Lokpriya Gopinath Bordoloi International Airport	IN
VEGY	Gaya Airport	IN
VEIM	Imphal Airport	IN
VEJS	Sonari Airport	IN
VEJT	Jorhat Airport	IN
VEKI	Kushinagar International Airport	IN
VEKR	Kailashahar Airport	IN
VEKU	Silchar Airport	IN
VELP	Lengpui Airport	IN
VELR	Lilabari North Lakhimpur Airport	IN
VEMN	Dibrugarh Airport	IN
VEMR	Dimapur Airport	IN
VEMZ	Muzaffarpur Airport	IN
VEPH	Panagarh Air Force Station	IN
VEPT	Jay Prakash Narayan Airport	IN
VERC	Birsa Munda Airport	IN
VERK	Rourkela Airport	IN
VETZ	Tezpur Airport	IN
VEVZ	Visakhapatnam Airport	IN
VEZO	Ziro Airport	IN
VGBR	Barisal Airport	BD
VGCB	Cox's Bazar Airport	BD
VGEG	Shah Amanat International Airport	BD
VGIS	Ishurdi Airport	BD
VGJR	Jessore Airport	BD
VGRJ	Shah Mokhdum Airport	BD
VGSD	Saidpur Airport	BD
VGSY	Osmany International Airport	BD
VGZR	Hazrat Shahjalal International Airport	BD
VHHH	Hong Kong International Airport	HK
VHSK	Shek Kong Air Base	HK
VIAG	Agra Airport / Agra Air Force Station	IN
VIAL	Prayagraj Airport	IN
VIAM	Ambala Air Force Station	IN
VIAR	Sri Guru Ram Dass Jee International Airport	IN
VIBK	Nal Airport	IN
VIBN	Lal Bahadur Shastri Airport	IN
VIBR	Kullu Manali Airport	IN
VIBT	Bhatinda Air Force Station	IN
VIBY	Bareilly Air Force Station	IN
VICG	Chandigarh International Airport	IN
VICX	Kanpur Airport	IN
VIDD	Safdarjung Airport	IN
VIDN	Dehradun Jolly Grant Airport	IN
VIDP	Indira Gandhi International Airport	IN
VIGG	Kangra Airport	IN
VIGR	Gwalior Airport	IN
VIHR	Hisar Airport	IN
VIJO	Jodhpur Airport	IN
VIJP	Jaipur International Airport	IN
VIJR	Jaisalmer Airport	IN
VIJU	Jammu Airport	IN
VIKG	Kishangarh Airport Ajmer	IN
VIKO	Kota Airport	IN
VILD	Ludhiana Airport	IN
VILH	Leh Kushok Bakula Rimpochee Airport	IN
VILK	Chaudhary Charan Singh International Airport	IN
VIPK	Pathankot Airport	IN
VIPT	Pantnagar Airport	IN
VISA	Sirsa Air Force Station	IN
VISR	Sheikh ul Alam International Airport	IN
VIUX	Udhampur Air Force Station	IN
VLLB	Luang Phabang International Airport	LA
VLPS	Pakse International Airport	LA
VLSK	Savannakhet Airport	LA
VLSN	Sam Neua Airport	LA
VLVT	Wattay International Airport	LA
VMI	Aeropuerto Nacional Dr. Juan Plate	PY
VMMC	Macau International Airport	MO
VN-0001	Dong Hoi Airport	VN
VN-0055	TK88	VN
VNBW	Gautam Buddha International Airport	NP
VNJP	Janakpur Airport	NP
VNKT	Tribhuvan International Airport	NP
VNNG	Nepalgunj Airport	NP
VNPK	Pokhara Airport	NP
VNTJ	Taplejung Airport	NP
VNVT	Biratnagar Airport	NP
VO55	Murod Kond Airport	IN
VO94	Campbell Bay Airport / INS Baaz	IN
VOAT	Agatti Airport	IN
VOBG	HAL Airport	IN
VOBI	Bellary Airport	IN
VOBL	Kempegowda International Airport	IN
VOBR	Bidar Airport / Bidar Air Force Station	IN
VOBZ	Vijayawada Airport	IN
VOCB	Coimbatore International Airport	IN
VOCI	Cochin International Airport	IN
VOCL	Calicut International Airport	IN
VOCP	Kadapa Airport	IN
VOCX	Car Nicobar Air Force Base	IN
VODG	Dundigul Air Force Academy	IN
VOHS	Rajiv Gandhi International Airport	IN
VOHY	Begumpet Airport	IN
VOKN	Kannur International Airport	IN
VOKU	Kurnool Airport	IN
VOMD	Madurai Airport	IN
VOML	Mangalore International Airport	IN
VOMM	Chennai International Airport	IN
VOPB	Veer Savarkar International Airport / INS Utkrosh	IN
VOPC	Pondicherry Airport	IN
VOPN	Sri Sathya Sai Airport	IN
VORY	Rajahmundry Airport	IN
VOSM	Salem Airport	IN
VOSR	Sindhudurg Airport	IN
VOTR	Tiruchirappalli International Airport	IN
VOTV	Thiruvananthapuram International Airport	IN
VQGP	Gelephu Airport	BT
VQPR	Paro International Airport	BT
VRDA	Maafaru International Airport	MV
VRMG	Gan International Airport	MV
VRMH	Hanimaadhoo Airport	MV
VRMK	Kadhdhoo Airport	MV
VRMM	Malé International Airport	MV
VRMT	Kaadedhdhoo Airport	MV
VRMV	Villa Airport	MV
VTBD	Don Mueang International Airport	TH
VTBK	Kamphaeng Saen Airport	TH
VTBL	Khok Kathiam Airport	TH
VTBO	Trat Airport	TH
VTBS	Suvarnabhumi Airport	TH
VTBU	U-Tapao International Airport	TH
VTCC	Chiang Mai International Airport	TH
VTCH	Mae Hong Son Airport	TH
VTCL	Lampang Airport	TH
VTCN	Nan Airport	TH
VTCP	Phrae Airport	TH
VTCT	Mae Fah Luang - Chiang Rai International Airport	TH
VTPB	Phetchabun Airport	TH
VTPH	Hua Hin Airport	TH
VTPI	Takhli Airport	TH
VTPM	Mae Sot Airport	TH
VTPO	Sukhothai Airport	TH
VTPP	Phitsanulok Airport	TH
VTPT	Tak Airport	TH
VTSB	Surat Thani Airport	TH
VTSC	Narathiwat Airport	TH
VTSE	Chumphon Airport	TH
VTSF	Nakhon Si Thammarat Airport	TH
VTSG	Krabi Airport	TH
VTSH	Songkhla Airport	TH
VTSK	Pattani Airport	TH
VTSM	Samui Airport	TH
VTSN	Cha Eian Airport	TH
VTSP	Phuket International Airport	TH
VTSR	Ranong Airport	TH
VTSS	Hat Yai International Airport	TH
VTST	Trang Airport	TH
VTUD	Udon Thani Airport	TH
VTUI	Sakon Nakhon Airport	TH
VTUJ	Surin Airport	TH
VTUK	Khon Kaen Airport	TH
VTUL	Loei Airport	TH
VTUO	Buri Ram Airport	TH
VTUQ	Nakhon Ratchasima Airport	TH
VTUU	Ubon Ratchathani Airport	TH
VTUV	Roi Et Airport	TH
VTUW	Nakhon Phanom Airport	TH
VVBM	Buon Ma Thuot Airport	VN
VVCI	Cat Bi International Airport	VN
VVCM	Cà Mau Airport	VN
VVCR	Cam Ranh International Airport / Cam Ranh Air Base	VN
VVCS	Con Dao Airport	VN
VVCT	Can Tho International Airport	VN
VVDB	Dien Bien Phu Airport	VN
VVDL	Lien Khuong Airport	VN
VVDN	Da Nang International Airport	VN
VVGL	Gia Lam Air Base	VN
VVNB	Noi Bai International Airport	VN
VVPB	Phu Bai International Airport	VN
VVPC	Phu Cat Airport	VN
VVPK	Pleiku Airport	VN
VVPQ	Phu Quoc International Airport	VN
VVRG	Rach Gia Airport	VN
VVTH	Dong Tac Airport	VN
VVTS	Tan Son Nhat International Airport	VN
VVVD	Van Don International Airport	VN
VVVH	Vinh Airport	VN
VYDW	Dawei Airport	MM
VYEL	Nay Pyi Taw International Airport	MM
VYKG	Kengtung Airport	MM
VYKP	Kyaukpyu Airport	MM
VYKT	Kawthoung Airport	MM
VYLK	Loikaw Airport	MM
VYLS	Lashio Airport	MM
VYMD	Mandalay International Airport	MM
VYME	Myeik Airport	MM
VYMK	Myitkyina Airport	MM
VYML	Meiktila Air Base	MM
VYMO	Momeik Airport	MM
VYMS	Mong Hsat Airport	MM
VYNP	Nampong Air Base	MM
VYNS	Namsang Airport	MM
VYPT	Putao Airport	MM
VYST	Shante Air Base	MM
VYSW	Sittwe Airport	MM
VYTD	Thandwe Airport	MM
VYTL	Tachileik Airport	MM
VYYY	Yangon International Airport	MM
WAAA	Hasanuddin International Airport	ID
WABB	Frans Kaisiepo Airport	ID
WABI	Nabire Airport	ID
WABP	Mozes Kilangin Airport	ID
WADD	Ngurah Rai (Bali) International Airport	ID
WADL	Lombok International Airport	ID
WAEW	Pitu Airport	ID
WAFB	Toraja Airport	ID
WAFF	Mutiara - SIS Al-Jufrie Airport	ID
WAFP	Kasiguncu Airport	ID
WAFW	Syukuran Aminuddin Amir Airport	ID
WAGG	Tjilik Riwut Airport	ID
WAHI	Yogyakarta International Airport	ID
WAHL	Tunggul Wulung Airport	ID
WAJJ	Dortheys Hiyo Eluay International Airport	ID
WAJO	Oksibil Airport	ID
WAKK	Mopah International Airport	ID
WAKT	Tanah Merah Airport	ID
WALK	Kalimarau Airport	ID
WALL	Sultan Aji Muhammad Sulaiman Sepinggan International Airport	ID
WALR	Juwata International Airport / Suharnoko Harbani AFB	ID
WALS	Aji Pangeran Tumenggung Pranoto International Airport	ID
WAMH	Naha Airport	ID
WAMM	Sam Ratulangi Airport	ID
WAMT	Sultan Babullah Airport	ID
WAON	Warukin Airport	ID
WAOO	Syamsudin Noor International Airport	ID
WAPF	Karel Sadsuitubun Airport	ID
WAPP	Pattimura International Airport	ID
WARA	Abdul Rachman Saleh Airport	ID
WARJ	Adisutjipto International Airport	ID
WARQ	Adisumarmo International Airport	ID
WARR	Juanda International Airport	ID
WARS	Achmad Yani Airport	ID
WASF	Fakfak Airport	ID
WASK	Kaimana Airport	ID
WASO	Babo Airport	ID
WASR	Rendani Airport	ID
WAVV	Wamena Airport	ID
WAWD	Matahora Airport	ID
WAXX	Domine Eduard Osok Airport	ID
WBGB	Bintulu Airport	MY
WBGG	Kuching International Airport	MY
WBGJ	Limbang Airport	MY
WBGK	Mukah Airport	MY
WBGM	Marudi Airport	MY
WBGR	Miri Airport	MY
WBGS	Sibu Airport	MY
WBGZ	Bario Airport	MY
WBKD	Lahad Datu Airport	MY
WBKK	Kota Kinabalu International Airport	MY
WBKL	Labuan Airport	MY
WBKS	Sandakan Airport	MY
WBKW	Tawau Airport	MY
WBMU	Mulu Airport	MY
WBSB	Brunei International Airport	BN
WIBB	Sultan Syarif Kasim II International Airport / Roesmin Nurjadin AFB	ID
WIBD	Pinang Kampai Airport	ID
WIBJ	Japura Airport	ID
WICA	Kertajati International Airport	ID
WICC	Husein Sastranegara International Airport	ID
WIDD	Hang Nadim International Airport	ID
WIHH	Halim Perdanakusuma International Airport	ID
WIII	Soekarno-Hatta International Airport	ID
WILL	Radin Inten II International Airport	ID
WIMB	Binaka Airport	ID
WIME	Aek Godang Airport	ID
WIMG	Tabing Airport	ID
WIMK	Soewondo Air Force Base	ID
WIMM	Kualanamu International Airport	ID
WIMS	Dr. Ferdinand Lumban Tobing Airport	ID
WIMU	Alas Leuser Airport	ID
WIOG	Nanga Pinoh Airport	ID
WIOK	Rahadi Osman Airport	ID
WION	Ranai-Natuna Airport	ID
WIOO	Supadio Airport	ID
WIOP	Pangsuma Airport	ID
WIOS	Sintang Airport	ID
WIPL	Fatmawati Soekarno Airport	ID
WIPP	Sultan Mahmud Badaruddin II Airport	ID
WIPQ	Pendopo Airport	ID
WIPT	Minangkabau International Airport	ID
WITC	Cut Nyak Dhien Airport	ID
WITK	Rembele Airport	ID
WITL	Lhok Sukon Airport	ID
WITT	Sultan Iskandar Muda International Airport	ID
WMAP	Kluang Airport	MY
WMBT	Tioman Airport	MY
WMKA	Sultan Abdul Halim Airport	MY
WMKB	RMAF Butterworth Air Base	MY
WMKC	Sultan Ismail Petra Airport	MY
WMKD	Kuantan Airport	MY
WMKE	Kerteh Airport	MY
WMKI	Sultan Azlan Shah Airport	MY
WMKJ	Senai International Airport	MY
WMKK	Kuala Lumpur International Airport	MY
WMKL	Langkawi International Airport	MY
WMKM	Malacca International Airport	MY
WMKN	Sultan Mahmud Airport	MY
WMKP	Penang International Airport	MY
WMSA	Sultan Abdul Aziz Shah International Airport	MY
WPDB	Suai Airport	TL
WPDL	Presidente Nicolau Lobato International Airport	TL
WPEC	Cakung Airport	TL
WPOC	Rota Do Sândalo Oecusse Airport	TL
WSAC	Changi Air Base (East)	SG
WSAG	Sembawang Air Base	SG
WSAP	Paya Lebar Air Base	SG
WSAT	Tengah Air Base	SG
WSSL	Seletar Airport	SG
WSSS	Singapore Changi Airport	SG
WUZ	Wuzhou Xijiang Airport	CN
XK-0001	KFOR Base Airfield	XK
XLLL	Soltsy-2 Air Base	RU
XLMV	Severomorsk-3 Naval Air Base	RU
XLWF	Fedotovo Naval Air Base	RU
XRWL	Lebyazhye Air Base	RU
XUBS	Smolensk North Airport	RU
XWPR	Rtishchevo Air Base	RU
YABA	Albany Airport	AU
YAMB	RAAF Base Amberley	AU
YARA	Ararat Airport	AU
YARM	Armidale Airport	AU
YAYE	Ayers Rock Connellan Airport	AU
YBAR	Barcaldine Airport	AU
YBAS	Alice Springs Airport	AU
YBBN	Brisbane International Airport	AU
YBCG	Gold Coast Airport	AU
YBCK	Blackall Airport	AU
YBCS	Cairns International Airport	AU
YBCV	Charleville Airport	AU
YBDV	Birdsville Airport	AU
YBHI	Broken Hill Airport	AU
YBHM	Hamilton Island Airport	AU
YBIE	Bedourie Airport	AU
YBKE	Bourke Airport	AU
YBLA	Benalla Airport	AU
YBMA	Mount Isa Airport	AU
YBMK	Mackay Airport	AU
YBNA	Ballina Byron Gateway Airport	AU
YBNS	Bairnsdale Airport	AU
YBOK	Oakey Army Aviation Centre	AU
YBOU	Boulia Airport	AU
YBP	Yibin Wuliangye Airport	CN
YBPN	Proserpine Whitsunday Coast Airport	AU
YBRK	Rockhampton Airport	AU
YBRM	Broome International Airport	AU
YBRN	Balranald Airport	AU
YBRW	Brewarrina Airport	AU
YBSU	Sunshine Coast Airport	AU
YBTH	Bathurst Airport	AU
YBTI	Bathurst Island Airport	AU
YBTL	Townsville Airport / RAAF Base Townsville	AU
YBTR	Blackwater Airport	AU
YBUD	Bundaberg Airport	AU
YBWP	Weipa Airport	AU
YBWW	Toowoomba Wellcamp Airport	AU
YCAR	Carnarvon Airport	AU
YCBA	Cobar Airport	AU
YCBB	Coonabarabran Airport	AU
YCBP	Coober Pedy Airport	AU
YCCA	Chinchilla Airport	AU
YCCY	Cloncurry Airport	AU
YCDU	Ceduna Airport	AU
YCEE	Cleve Airport	AU
YCFS	Coffs Harbour Airport	AU
YCIN	RAAF Base Curtin	AU
YCKN	Cooktown Airport	AU
YCMT	Clermont Airport	AU
YCMU	Cunnamulla Airport	AU
YCNM	Coonamble Airport	AU
YCOE	Coen Airport	AU
YCOM	Cooma Snowy Mountains Airport	AU
YCOR	Corowa Airport	AU
YCRG	Corryong Airport	AU
YCTM	Cootamundra Airport	AU
YCWR	Cowra Airport	AU
YDBI	Dirranbandi Airport	AU
YDBY	Derby Airport	AU
YDLQ	Deniliquin Airport	AU
YDPO	Devonport Airport	AU
YDYS	Dysart Airport	AU
YECH	Echuca Airport	AU
YELD	Elcho Island Airport	AU
YEML	Emerald Airport	AU
YESP	Esperance Airport	AU
YEWA	Eliwana	AU
YFBS	Forbes Airport	AU
YFRT	Forrest Airport	AU
YFTZ	Fitzroy Crossing Airport	AU
YGDH	Gunnedah Airport	AU
YGEL	Geraldton Airport	AU
YGFN	Grafton Airport	AU
YGLA	Gladstone Airport	AU
YGLB	Goulburn Airport	AU
YGLI	Glen Innes Airport	AU
YGPT	Garden Point Airport	AU
YGTE	Groote Eylandt Airport	AU
YGTH	Griffith Airport	AU
YHAY	Hay Airport	AU
YHBA	Hervey Bay Airport	AU
YHID	Horn Island Airport	AU
YHLC	Halls Creek Airport	AU
YHML	Hamilton Airport	AU
YHOT	Mount Hotham Airport	AU
YHPN	Hopetoun Airport	AU
YHSM	Horsham Airport	AU
YIVL	Inverell Airport	AU
YKER	Kerang Airport	AU
YKII	King Island Airport	AU
YKMP	Kempsey Airport	AU
YKOW	Kowanyama Airport	AU
YKRY	Kingaroy Airport	AU
YKSC	Kingscote Airport	AU
YLEC	Leigh Creek Airport	AU
YLEO	Leonora Airport	AU
YLHR	Lockhart River Airport	AU
YLIS	Lismore Airport	AU
YLRD	Lightning Ridge Airport	AU
YLRE	Longreach Airport	AU
YLST	Leinster Airport	AU
YLTV	Latrobe Valley Airport	AU
YMAV	Avalon Airport	AU
YMAY	Albury Airport	AU
YMBA	Mareeba Airport	AU
YMDG	Mudgee Airport	AU
YMEK	Meekatharra Airport	AU
YMEN	Melbourne Essendon Airport	AU
YMER	Merimbula Airport	AU
YMES	RAAF Base East Sale	AU
YMGD	Maningrida Airport	AU
YMHB	Hobart International Airport	AU
YMIA	Mildura Airport	AU
YMLT	Launceston Airport	AU
YMMB	Melbourne Moorabbin Airport	AU
YMML	Melbourne International Airport	AU
YMNE	Mount Keith Airport	AU
YMOG	Mount Magnet Airport	AU
YMOR	Moree Airport	AU
YMRB	Moranbah Airport	AU
YMRY	Moruya Airport	AU
YMTG	Mount Gambier Airport	AU
YNAR	Narrandera Airport	AU
YNBR	Narrabri Airport	AU
YNGU	Ngukurr Airport	AU
YNRM	Narromine Airport	AU
YNT	Yantai Penglai International Airport	CN
YNTN	Normanton Airport	AU
YNWN	Newman Airport	AU
YORG	Orange Airport	AU
YPAD	Adelaide International Airport	AU
YPAG	Port Augusta Airport	AU
YPBO	Paraburdoo Airport	AU
YPCC	Cocos (Keeling) Islands Airport	CC
YPDN	Darwin International Airport / RAAF Darwin	AU
YPEA	RAAF Base Pearce	AU
YPED	RAAF Base Edinburgh	AU
YPGV	Gove Airport	AU
YPIR	Port Pirie Airport	AU
YPJT	Perth Jandakot Airport	AU
YPKA	Karratha Airport	AU
YPKG	Kalgoorlie Boulder Airport	AU
YPKS	Parkes Airport	AU
YPKT	Port Keats Airport	AU
YPKU	East Kimberley Regional (Kununurra) Airport	AU
YPLC	Port Lincoln Airport	AU
YPLM	Learmonth Airport	AU
YPMQ	Port Macquarie Airport	AU
YPOD	Portland Airport	AU
YPPD	Port Hedland International Airport	AU
YPPH	Perth International Airport	AU
YPTN	Tindal Airport	AU
YPXM	Christmas Island Airport	CX
YQLP	Quilpie Airport	AU
YREN	Renmark Airport	AU
YROM	Roma Airport	AU
YSBK	Sydney Bankstown Airport	AU
YSCB	Canberra International Airport	AU
YSCN	Camden Airport	AU
YSDU	Dubbo City Regional Airport	AU
YSHK	Shark Bay Airport	AU
YSHL	Shellharbour Airport	AU
YSHT	Shepparton Airport	AU
YSMI	Smithton Airport	AU
YSNB	Snake Bay Airport	AU
YSNF	Norfolk Island International Airport	NF
YSNW	Naval Air Station Nowra - HMAS Albatross	AU
YSRI	RAAF Base Richmond	AU
YSSY	Sydney Kingsford Smith International Airport	AU
YSTW	Tamworth Airport	AU
YSWG	Wagga Wagga City Airport	AU
YSWH	Swan Hill Airport	AU
YSWL	Stawell Airport	AU
YTEF	Telfer Airport	AU
YTEM	Temora Airport	AU
YTGM	Thargomindah Airport	AU
YTIB	Tibooburra Airport	AU
YTMU	Tumut Airport	AU
YTNG	Thangool Airport	AU
YTNK	Tennant Creek Airport	AU
YTRE	Taree Airport	AU
YWDH	Windorah Airport	AU
YWGT	Wangaratta Airport	AU
YWHA	Whyalla Airport	AU
YWKB	Warracknabeal Airport	AU
YWLG	Walgett Airport	AU
YWLM	Newcastle Airport	AU
YWLU	Wiluna Airport	AU
YWRN	Warren Airport	AU
YWSL	West Sale Airport	AU
YWTN	Winton Airport	AU
YWWL	West Wyalong Airport	AU
YWYY	Wynyard Airport	AU
YYA	Yueyang Sanhe Airport	CN
YYNG	Young Airport	AU
Z19O	Wujah Al Hajar Air Base	LB
ZBAA	Beijing Capital International Airport	CN
ZBAD	Beijing Daxing International Airport	CN
ZBBB	Beijing Xijiao Airport	CN
ZBCD	Chengde Puning Airport	CN
ZBCF	Chifeng Yulong Airport	CN
ZBDH	Qinhuangdao Beidaihe Airport	CN
ZBDS	Ordos Ejin Horo Airport	CN
ZBER	Erenhot Saiwusu International Airport	CN
ZBES	Arxan Yi'ershi Airport	CN
ZBHD	Handan Airport	CN
ZBHH	Hohhot Baita International Airport	CN
ZBHZ	Holingol Huolinhe Airport	CN
ZBLA	Hulunbuir Hailar Airport	CN
ZBLF	Linfen Yaodu Airport	CN
ZBLL	Lüliang Dawu Airport	CN
ZBMZ	Manzhouli Xijiao Airport	CN
ZBOW	Baotou Donghe Airport	CN
ZBSJ	Shijiazhuang Zhengding International Airport	CN
ZBTJ	Tianjin Binhai International Airport	CN
ZBTL	Tongliao Airport	CN
ZBUC	Ulanqab Jining Airport	CN
ZBXH	Xilinhot Airport	CN
ZBYN	Taiyuan Wusu Airport	CN
ZBYZ	Bayannur Tianjitai Airport	CN
ZBZL	Zhalantun Genghis Khan Airport	CN
ZGCD	Changde Taohuayuan Airport	CN
ZGCJ	Huaihua Zhijiang Airport	CN
ZGCZ	Chenzhou Beihu Airport	CN
ZGGG	Guangzhou Baiyun International Airport	CN
ZGHA	Changsha Huanghua International Airport	CN
ZGHC	Hechi Jinchengjiang Airport	CN
ZGKL	Guilin Liangjiang International Airport	CN
ZGLG	Yongzhou Lingling Airport	CN
ZGNN	Nanning Wuxu Airport	CN
ZGOW	Jieyang Chaoshan International Airport	CN
ZGSD	Zhuhai Jinwan Airport	CN
ZGSY	Shaoyang Wugang Airport	CN
ZGSZ	Shenzhen Bao'an International Airport	CN
ZGYL	Yulin Fumian Airport	CN
ZGZH	Liuzhou Bailian Airport / Bailian Air Base	CN
ZHCC	Zhengzhou Xinzheng International Airport	CN
ZHES	Enshi Xujiaping Airport	CN
ZHGH	Guangzhou MR Air Base / Guanghua Airport	CN
ZHHH	Wuhan Tianhe International Airport	CN
ZHJZ	Jingzhou Shashi Airport	CN
ZHLY	Luoyang Beijiao Airport	CN
ZHSN	Shennongjia Hongping Airport	CN
ZHSY	Shiyan Wudangshan Airport	CN
ZHXF	Xiangyang Liuji Airport	CN
ZHYC	Yichang Sanxia Airport	CN
ZHZH	Herschel Island Field	CA
ZJHK	Haikou Meilan International Airport	CN
ZJQH	Qionghai Bo'ao Airport	CN
ZJSY	Sanya Phoenix International Airport	CN
ZKPY	Pyongyang Sunan International Airport	KP
ZKSC	Sunchon Air Base	KP
ZKSD	Sondok Airport	KP
ZKWS	Wonsan Kalma International Airport	KP
ZLDH	Dunhuang Mogao International Airport	CN
ZLGM	Golmud Airport	CN
ZLGY	Guyuan Liupanshan Airport	CN
ZLHX	Huatugou Airport	CN
ZLIC	Yinchuan Hedong International Airport	CN
ZLJN	Jining Qufu Airport	CN
ZLLL	Lanzhou Zhongchuan International Airport	CN
ZLLN	Longnan Chengzhou Airport	CN
ZLQY	Qingyang Xifeng Airport	CN
ZLSN	Xi'an Xiguan Airport	CN
ZLXH	Gannan Xiahe Airport	CN
ZLXN	Xining Caojiabao International Airport	CN
ZLXY	Xi'an Xianyang International Airport	CN
ZLZW	Zhongwei Shapotou Airport	CN
ZMAH	Arvaikheer Airport	MN
ZMAT	Altai Airport	MN
ZMBH	Bayankhongor Airport	MN
ZMBN	Bulgan Airport	MN
ZMBU	Baruun Urt Airport	MN
ZMCD	Choibalsan Airport	MN
ZMCK	Ulaanbaatar Chinggis Khaan International Airport	MN
ZMDZ	Dalanzadgad Airport	MN
ZMKD	Khovd Airport	MN
ZMMN	Mörön Airport	MN
ZMUB	Buyant-Ukhaa International Airport	MN
ZPCW	Cangyuan Washan Airport	CN
ZPDL	Dali Fengyi Airport	CN
ZPDQ	Diqing Shangri-La Airport	CN
ZPJH	Xishuangbanna Gasa International Airport	CN
ZPJM	Lancang Jingmai Airport	CN
ZPLJ	Lijiang Sanyi International Airport	CN
ZPLX	Dehong Mangshi Airport	CN
ZPPP	Kunming Changshui International Airport	CN
ZRI	Stevanus Rumbewas Airport	ID
ZSAM	Xiamen Gaoqi International Airport	CN
ZSAQ	Anqing Tianzhushan Airport / Anqing North Air Base	CN
ZSBB	Bengbu Airport	CN
ZSCG	Changzhou Benniu International Airport	CN
ZSCN	Nanchang Changbei International Airport	CN
ZSFY	Fuyang Xiguan Airport	CN
ZSFZ	Fuzhou Changle International Airport	CN
ZSHC	Hangzhou Xiaoshan International Airport	CN
ZSHZ	Heze Mudan Airport	CN
ZSJD	Jingdezhen Luojia Airport	CN
ZSJN	Jinan Yaoqiang International Airport	CN
ZSJU	Quzhou Airport	CN
ZSLD	Longyan Guanzhishan Airport	CN
ZSLQ	Taizhou Luqiao Airport	CN
ZSNB	Ningbo Lishe International Airport	CN
ZSNJ	Nanjing Lukou International Airport	CN
ZSOF	Hefei Xinqiao International Airport	CN
ZSPD	Shanghai Pudong International Airport	CN
ZSQZ	Quanzhou Jinjiang International Airport	CN
ZSRG	Rugao Air Base	CN
ZSRZ	Rizhao Shanzihe Airport	CN
ZSSS	Shanghai Hongqiao International Airport	CN
ZSSZ	Suzhou Guangfu Airport	CN
ZSTX	Tunxi International Airport	CN
ZSWA	Wuhu Xuanzhou Airport	CN
ZSWF	Weifang Nanyuan Airport	CN
ZSWH	Weihai Dashuibo Airport	CN
ZSWX	Sunan Shuofang International Airport	CN
ZSWY	Nanping Wuyishan Airport	CN
ZSWZ	Wenzhou Longwan International Airport	CN
ZSXZ	Xuzhou Guanyin International Airport	CN
ZSYA	Yangzhou Taizhou Airport	CN
ZSYC	Yichun Mingyueshan Airport	CN
ZSYN	Yancheng Nanyang International Airport	CN
ZSYW	Yiwu Airport	CN
ZUAL	Ngari Gunsa Airport	CN
ZUAS	Anshun Huangguoshu Airport	CN
ZUBD	Qamdo Bangda Airport	CN
ZUBJ	Bijie Feixiong Airport	CN
ZUCK	Chongqing Jiangbei International Airport	CN
ZUDC	Daocheng Yading Airport	CN
ZUGU	Guangyuan Panlong Airport	CN
ZUGY	Guiyang Longdongbao International Airport	CN
ZUJZ	Jiuzhai Huanglong Airport	CN
ZUKD	Kangding Airport	CN
ZUKJ	Kaili Huangping Airport	CN
ZULS	Lhasa Gonggar Airport	CN
ZULZ	Luzhou Yunlong Airport	CN
ZUMT	Zunyi Maotai Airport	CN
ZUMY	Mianyang Nanjiao Airport	CN
ZUNP	Liping Airport	CN
ZUNZ	Nyingchi Mainling Airport	CN
ZUPS	Liupanshui Yuezhao Airport	CN
ZUTC	Tengchong Tuofeng Airport	CN
ZUTF	Chengdu Tianfu International Airport	CN
ZUTR	Tongren Fenghuang Airport	CN
ZUUU	Chengdu Shuangliu International Airport	CN
ZUWL	Chongqing Xiannüshan Airport	CN
ZUXC	Xichang Qingshan Airport	CN
ZUYI	Xingyi Wanfenglin Airport	CN
ZUZY	Zunyi Xinzhou Airport	CN
ZWAK	Aksu Hongqipo Airport	CN
ZWAX	Bole Alashankou Airport	CN
ZWCM	Qiemo Yudu Airport	CN
ZWFY	Fuyun Koktokay Airport	CN
ZWHM	Hami Airport	CN
ZWKL	Korla Licheng Airport	CN
ZWKN	Burqin Kanas Airport	CN
ZWNL	Xinyuan Nalati Airport	CN
ZWRQ	Ruoqiang Loulan Airport	CN
ZWSC	Shache Airport	CN
ZWSH	Kashgar Airport	CN
ZWSS	Shanshan Airport	CN
ZWTL	Turpan Jiaohe Airport	CN
ZWTN	Hotan Airport	CN
ZWWW	Ürümqi Diwopu International Airport	CN
ZYAS	Anshan Teng'ao Airport / Anshan Air Base	CN
ZYCC	Changchun Longjia International Airport	CN
ZYCH	Changhai Airport	CN
ZYCY	Chaoyang Airport	CN
ZYDU	Wudalianchi Dedu Airport	CN
ZYFY	Fuyuan Dongji Aiport	CN
ZYHB	Harbin Taiping International Airport	CN
ZYHE	Heihe Aihui Airport	CN
ZYJM	Jiamusi Dongjiao Airport	CN
ZYJS	Jiansanjiang Shidi Airport	CN
ZYJX	Jixi Xingkaihu Airport	CN
ZYLD	Yichun Lindu Airport	CN
ZYLS	Yushu Batang Airport	CN
ZYMD	Mudanjiang Hailang International Airport	CN
ZYMH	Mohe Gulian Airport	CN
ZYQQ	Qiqihar Sanjiazi Airport	CN
ZYSQ	Songyuan Chaganhu Airport	CN
ZYTL	Dalian Zhoushuizi International Airport	CN
ZYTN	Tonghua Sanyuanpu Airport	CN
ZYTX	Shenyang Taoxian International Airport	CN
ZYYJ	Yanji Chaoyangchuan Airport	CN
ZYYK	Yingkou Lanqi Airport	CN
ZYYY	Shenyang Dongta Airport	CN